Enrollmentno,sub1,sub2,sub3,sub4,sub5,Total,Rank
E8249,98,92,99,91,100,480,1
E7678,95,92,100,93,99,479,2
E5092,98,94,93,93,96,474,3
E6273,99,95,95,99,83,471,4
E5952,96,92,96,87,100,471,5
E6168,87,95,97,97,93,469,6
E8045,99,97,99,75,94,464,7
E0466,90,95,91,93,92,461,8
E4812,71,100,95,94,100,460,9
E1499,84,82,100,96,98,460,10
E0599,99,84,96,93,88,460,11
E7419,94,91,93,99,83,460,12
E5360,72,100,96,93,99,460,13
E7159,88,98,97,84,92,459,14
E9899,96,98,75,94,95,458,15
E0802,91,100,99,75,93,458,16
E4162,100,78,97,96,86,457,17
E5475,95,80,97,96,89,457,18
E1683,88,98,96,90,85,457,19
E7597,81,100,94,85,97,457,20
E8631,100,92,97,85,82,456,21
E6142,97,72,97,100,90,456,22
E9888,94,75,99,90,98,456,23
E2279,94,99,87,81,94,455,24
E9968,90,87,93,97,88,455,25
E4363,79,97,92,89,98,455,26
E3990,69,98,95,98,95,455,27
E4538,100,68,94,99,93,454,28
E8705,79,100,94,88,93,454,29
E7068,85,99,96,74,100,454,30
E6507,76,95,99,95,89,454,31
E4325,95,68,95,96,100,454,32
E8388,95,81,97,90,90,453,33
E6963,81,100,96,93,83,453,34
E8137,90,73,97,92,100,452,35
E9151,73,100,89,91,99,452,36
E7886,91,99,84,81,96,451,37
E7013,71,100,93,92,95,451,38
E7428,100,93,79,92,87,451,39
E4215,98,87,97,97,72,451,40
E6011,89,86,97,88,91,451,41
E3982,100,93,99,100,59,451,42
E6733,99,97,65,90,99,450,43
E3023,94,80,91,84,100,449,44
E9116,87,92,94,86,90,449,45
E8999,76,96,100,96,80,448,46
E3563,87,76,99,86,100,448,47
E2192,73,89,90,98,98,448,48
E2808,90,88,92,92,86,448,49
E8505,65,100,86,98,99,448,50
E7176,98,91,87,80,91,447,51
E9219,84,86,94,84,99,447,52
E8253,99,87,91,91,79,447,53
E3994,96,98,82,83,88,447,54
E3710,93,88,92,93,80,446,55
E2146,84,83,92,91,96,446,56
E6424,92,91,72,91,100,446,57
E1554,72,99,90,88,97,446,58
E7748,96,83,86,81,100,446,59
E9783,91,92,71,98,93,445,60
E5167,98,99,86,95,67,445,61
E8413,82,96,98,86,83,445,62
E4132,82,94,88,94,87,445,63
E2871,100,48,100,98,99,445,64
E1477,92,67,98,89,98,444,65
E3389,100,93,95,75,81,444,66
E1300,96,100,86,76,86,444,67
E8309,98,96,95,98,56,443,68
E1652,93,68,100,96,86,443,69
E5335,78,97,80,90,98,443,70
E4150,89,82,72,100,100,443,71
E9359,90,93,77,83,100,443,72
E4794,96,95,95,97,60,443,73
E4293,71,96,100,88,88,443,74
E1600,86,77,100,99,81,443,75
E2527,88,93,96,73,93,443,76
E6780,96,87,95,91,74,443,77
E4958,86,90,93,76,97,442,78
E1632,86,96,92,92,76,442,79
E3409,96,86,94,70,96,442,80
E6957,86,91,79,93,93,442,81
E3010,86,91,86,98,81,442,82
E0770,96,90,78,87,91,442,83
E4145,71,96,75,99,100,441,84
E9340,90,86,74,96,95,441,85
E3111,90,99,61,93,97,440,86
E9712,92,86,79,86,97,440,87
E8598,95,94,79,79,93,440,88
E0295,100,94,95,85,66,440,89
E7497,93,96,56,98,97,440,90
E5883,77,93,88,84,98,440,91
E8148,86,80,94,83,97,440,92
E4621,97,57,92,100,94,440,93
E0304,80,81,98,91,89,439,94
E4906,100,80,88,97,74,439,95
E7201,95,93,83,85,83,439,96
E0034,77,100,98,100,64,439,97
E8612,98,91,97,62,91,439,98
E4445,97,67,92,90,93,439,99
E9932,96,82,70,97,94,439,100
E8091,98,98,99,65,79,439,101
E5212,100,62,86,99,91,438,102
E3016,100,90,69,92,87,438,103
E1540,88,71,99,94,86,438,104
E0253,91,97,99,80,71,438,105
E8993,99,79,73,94,93,438,106
E9180,100,99,88,92,59,438,107
E7105,92,71,86,91,98,438,108
E1596,72,98,95,90,83,438,109
E4082,94,87,82,78,97,438,110
E8406,90,70,88,92,98,438,111
E2149,98,81,99,60,100,438,112
E9590,86,84,91,77,99,437,113
E5078,75,89,95,85,93,437,114
E8426,89,87,97,65,99,437,115
E0522,66,92,98,92,89,437,116
E2144,86,95,75,91,90,437,117
E0227,96,88,94,88,71,437,118
E6200,71,100,87,88,91,437,119
E7377,92,92,93,60,99,436,120
E1017,94,98,87,70,87,436,121
E8738,86,64,93,99,94,436,122
E1419,85,74,95,87,95,436,123
E5172,82,74,91,93,96,436,124
E9648,85,99,82,94,76,436,125
E4881,90,98,77,85,86,436,126
E5691,84,87,93,100,72,436,127
E7094,86,95,100,74,81,436,128
E7411,81,92,63,100,100,436,129
E4691,97,93,82,80,84,436,130
E2301,84,80,93,90,89,436,131
E8752,98,94,99,72,73,436,132
E5576,100,74,98,82,82,436,133
E6275,85,89,92,88,81,435,134
E3565,96,62,98,90,89,435,135
E3241,77,78,87,93,100,435,136
E8494,99,62,84,91,99,435,137
E0563,98,95,89,100,53,435,138
E7994,98,96,45,99,97,435,139
E4648,74,72,98,95,96,435,140
E8075,81,93,97,86,78,435,141
E1901,90,78,87,98,82,435,142
E2420,78,93,93,82,89,435,143
E4359,88,67,96,87,97,435,144
E8455,86,75,91,85,98,435,145
E8651,94,92,66,86,97,435,146
E2277,99,62,97,99,77,434,147
E1205,99,94,87,74,80,434,148
E5631,98,65,84,89,98,434,149
E6670,94,72,79,91,98,434,150
E1444,83,94,62,97,98,434,151
E7361,75,75,92,94,98,434,152
E8072,100,90,85,70,89,434,153
E4892,100,89,61,87,96,433,154
E9335,74,79,95,94,91,433,155
E4090,63,82,99,96,93,433,156
E8178,96,76,78,90,93,433,157
E5741,71,95,91,79,97,433,158
E7436,70,81,100,87,95,433,159
E5867,74,94,99,94,72,433,160
E6271,65,80,98,97,93,433,161
E1386,96,91,71,97,78,433,162
E8418,81,93,77,84,98,433,163
E0703,64,87,100,98,84,433,164
E5955,90,96,87,97,63,433,165
E2769,84,89,87,94,79,433,166
E7131,85,97,82,78,91,433,167
E3301,61,94,79,99,100,433,168
E7643,88,92,98,71,84,433,169
E2225,89,73,99,77,95,433,170
E6495,60,98,100,98,77,433,171
E6722,88,68,87,94,95,432,172
E7690,95,85,76,87,89,432,173
E0365,100,53,88,99,92,432,174
E5311,93,95,94,68,82,432,175
E3596,94,95,74,71,98,432,176
E7692,94,94,70,100,74,432,177
E5708,83,93,79,87,90,432,178
E4216,90,97,99,65,81,432,179
E7018,99,84,67,86,96,432,180
E4639,97,77,87,88,83,432,181
E7036,90,83,68,99,92,432,182
E7447,90,89,88,78,86,431,183
E0793,76,99,68,97,91,431,184
E3285,89,53,100,91,98,431,185
E9481,86,94,100,61,90,431,186
E2595,96,69,83,97,86,431,187
E1863,76,86,89,88,92,431,188
E8566,90,82,75,96,88,431,189
E0917,94,98,93,68,78,431,190
E5840,82,79,98,93,79,431,191
E8820,90,96,99,53,93,431,192
E4866,68,80,97,97,89,431,193
E5950,100,83,85,76,86,430,194
E2601,90,56,91,99,94,430,195
E4065,91,95,91,92,61,430,196
E2850,100,100,94,73,63,430,197
E7632,67,97,96,86,84,430,198
E5128,97,97,76,72,88,430,199
E8235,99,98,79,61,93,430,200
E0550,96,92,89,58,95,430,201
E0031,92,49,96,98,94,429,202
E5199,88,86,98,61,96,429,203
E0846,95,90,97,71,76,429,204
E2625,100,88,99,62,80,429,205
E9853,86,80,96,68,99,429,206
E2020,78,94,93,75,89,429,207
E3189,99,52,100,96,82,429,208
E2054,80,82,87,100,80,429,209
E7344,51,96,94,96,92,429,210
E5436,96,100,44,97,92,429,211
E7308,65,78,89,100,96,428,212
E0404,100,89,53,86,100,428,213
E3263,88,61,91,98,90,428,214
E4315,81,82,82,92,91,428,215
E3273,96,49,89,100,94,428,216
E2079,53,92,98,86,99,428,217
E6690,92,90,77,99,70,428,218
E2978,64,90,99,82,93,428,219
E5398,92,64,83,89,100,428,220
E2218,72,87,94,79,96,428,221
E2807,90,84,82,95,76,427,222
E3880,99,77,68,89,94,427,223
E4071,65,96,75,94,97,427,224
E0853,88,94,70,87,88,427,225
E6368,89,83,85,96,74,427,226
E3028,88,99,41,99,100,427,227
E0553,96,94,88,100,49,427,228
E4619,92,71,73,94,97,427,229
E1244,85,69,82,97,94,427,230
E3590,93,88,64,86,95,426,231
E6504,94,88,46,98,100,426,232
E1575,65,89,87,85,100,426,233
E8340,97,63,97,92,77,426,234
E9716,95,97,79,73,82,426,235
E9301,87,95,93,73,78,426,236
E8093,84,85,100,75,82,426,237
E9367,86,76,84,93,87,426,238
E4498,98,85,70,93,80,426,239
E3095,78,94,86,86,82,426,240
E5164,61,88,85,99,93,426,241
E1941,99,95,69,99,64,426,242
E3487,82,78,97,79,90,426,243
E1503,89,82,99,96,60,426,244
E5228,63,81,94,96,92,426,245
E7709,82,70,97,88,89,426,246
E9272,57,100,92,89,88,426,247
E9505,77,78,98,90,82,425,248
E8017,67,87,96,89,86,425,249
E7956,91,95,93,60,86,425,250
E6247,96,94,81,54,100,425,251
E9920,86,98,94,82,65,425,252
E2187,97,86,69,96,77,425,253
E4831,100,99,82,53,91,425,254
E4305,82,99,97,83,64,425,255
E4987,88,67,97,77,96,425,256
E2396,91,60,98,98,78,425,257
E7904,92,88,68,87,90,425,258
E6436,96,70,98,71,90,425,259
E4983,89,65,87,89,95,425,260
E6379,91,100,45,100,89,425,261
E5188,98,89,47,96,95,425,262
E5763,92,88,66,82,97,425,263
E7452,89,100,92,82,62,425,264
E6376,86,82,84,97,75,424,265
E0962,77,89,98,98,62,424,266
E9967,100,69,99,96,60,424,267
E5269,72,98,90,91,73,424,268
E9184,98,52,93,81,100,424,269
E8541,98,78,70,95,83,424,270
E3630,94,89,65,87,89,424,271
E0915,92,88,66,91,87,424,272
E1198,94,94,92,100,44,424,273
E0311,95,97,81,64,87,424,274
E4946,69,98,91,71,95,424,275
E5758,84,79,93,75,93,424,276
E1410,44,90,92,100,98,424,277
E0551,76,86,95,73,94,424,278
E0247,88,93,94,87,62,424,279
E7757,91,71,97,90,75,424,280
E7863,80,99,100,63,82,424,281
E9749,89,88,95,57,95,424,282
E6518,90,98,65,83,87,423,283
E3909,85,68,95,76,99,423,284
E6631,74,82,97,100,70,423,285
E6163,86,77,91,86,83,423,286
E8703,84,97,68,87,87,423,287
E3797,100,65,85,95,78,423,288
E4461,85,93,95,76,74,423,289
E0241,70,88,100,99,66,423,290
E1601,88,69,97,90,79,423,291
E8771,80,91,97,69,86,423,292
E8307,97,53,97,92,84,423,293
E3421,90,62,92,81,98,423,294
E8225,80,80,96,95,72,423,295
E4733,91,52,89,95,96,423,296
E3288,83,88,90,82,80,423,297
E4664,59,92,98,94,80,423,298
E3173,79,84,82,97,81,423,299
E3864,97,63,93,83,87,423,300
E6337,88,100,62,88,85,423,301
E9704,70,93,100,95,65,423,302
E5265,76,93,97,87,70,423,303
E7818,88,87,78,71,99,423,304
E3295,81,73,98,84,86,422,305
E0040,63,86,96,77,100,422,306
E7568,88,82,92,66,94,422,307
E9631,76,92,98,89,67,422,308
E5789,93,83,65,83,98,422,309
E8987,67,98,93,91,73,422,310
E5723,88,85,98,92,59,422,311
E7755,98,87,50,92,95,422,312
E3141,56,91,91,92,92,422,313
E5191,99,59,96,83,85,422,314
E1326,84,78,99,89,72,422,315
E8734,83,85,73,99,82,422,316
E5300,71,99,71,85,96,422,317
E4898,73,61,98,100,90,422,318
E4885,85,69,85,94,89,422,319
E8486,92,81,98,66,85,422,320
E7252,92,79,98,94,59,422,321
E6605,79,83,92,92,76,422,322
E7850,80,75,100,69,98,422,323
E7790,94,95,61,94,78,422,324
E5431,82,73,91,95,81,422,325
E0798,88,95,93,71,75,422,326
E0902,93,97,76,72,84,422,327
E7541,96,80,93,63,90,422,328
E2137,87,83,88,94,70,422,329
E4783,48,95,95,98,86,422,330
E2195,55,99,88,80,100,422,331
E2166,99,78,72,77,96,422,332
E0056,70,81,100,80,91,422,333
E0596,98,59,94,83,88,422,334
E1356,92,95,65,87,82,421,335
E4043,86,77,91,72,95,421,336
E8571,96,67,90,69,99,421,337
E7842,91,95,82,83,70,421,338
E4545,66,89,86,90,90,421,339
E6881,76,99,76,78,92,421,340
E6985,75,88,100,85,73,421,341
E8592,67,76,93,94,91,421,342
E9566,70,64,98,95,94,421,343
E3993,99,66,77,87,92,421,344
E7592,84,93,88,71,85,421,345
E3653,98,83,93,48,98,420,346
E7464,84,70,94,79,93,420,347
E1615,69,74,87,96,94,420,348
E5063,95,50,81,95,99,420,349
E8819,92,75,84,72,97,420,350
E1648,99,73,94,82,72,420,351
E3853,98,98,86,46,92,420,352
E9851,67,74,99,97,83,420,353
E0580,93,94,80,54,99,420,354
E1947,63,77,93,100,87,420,355
E5457,49,95,93,87,96,420,356
E9235,94,84,85,90,67,420,357
E1613,93,88,91,91,57,420,358
E6709,85,97,70,95,73,420,359
E8012,75,94,91,86,74,420,360
E3413,68,74,89,97,92,420,361
E6409,84,83,77,93,83,420,362
E9088,91,76,79,88,86,420,363
E3368,77,98,81,64,100,420,364
E7396,89,70,95,72,94,420,365
E8737,86,90,62,89,93,420,366
E4678,70,97,85,100,68,420,367
E7456,84,80,97,69,89,419,368
E1145,93,48,98,89,91,419,369
E3293,91,70,95,80,83,419,370
E2390,73,77,96,81,92,419,371
E7600,81,100,93,84,61,419,372
E4322,93,54,88,96,88,419,373
E3358,95,85,80,85,74,419,374
E3470,93,95,84,64,83,419,375
E5601,64,92,79,92,92,419,376
E4845,69,71,93,86,100,419,377
E1995,97,89,98,91,44,419,378
E3891,90,91,53,94,91,419,379
E8971,97,96,86,82,58,419,380
E1142,87,65,91,90,86,419,381
E7940,68,100,98,83,70,419,382
E9031,80,72,92,79,96,419,383
E7634,88,53,87,97,94,419,384
E1926,97,96,87,65,74,419,385
E7587,95,76,89,76,83,419,386
E7340,96,90,67,77,89,419,387
E4170,65,98,88,83,84,418,388
E4540,91,91,85,56,95,418,389
E3237,92,93,94,59,80,418,390
E3638,95,100,76,68,79,418,391
E2711,90,48,99,100,81,418,392
E1486,64,91,72,95,96,418,393
E2362,64,91,98,75,90,418,394
E2066,79,98,89,67,85,418,395
E1543,61,59,100,100,98,418,396
E8689,96,87,92,94,49,418,397
E0113,62,91,81,84,100,418,398
E5098,71,85,98,88,76,418,399
E4437,62,93,87,94,82,418,400
E1100,99,100,72,52,95,418,401
E6449,79,100,88,88,63,418,402
E8579,93,66,98,88,73,418,403
E2630,45,97,86,97,93,418,404
E8033,82,86,72,93,85,418,405
E7168,89,47,89,98,94,417,406
E6208,82,66,92,81,96,417,407
E2401,91,81,50,98,97,417,408
E3964,84,98,54,83,98,417,409
E9254,100,84,83,59,91,417,410
E1589,66,77,86,96,92,417,411
E4897,66,90,85,79,97,417,412
E6186,83,99,64,72,99,417,413
E1458,97,84,82,66,88,417,414
E5570,91,78,75,93,80,417,415
E3047,67,90,77,90,93,417,416
E5001,61,71,91,97,97,417,417
E3659,99,64,63,94,97,417,418
E2928,83,63,79,95,97,417,419
E9531,54,75,95,100,93,417,420
E3554,89,90,92,86,60,417,421
E6830,98,71,65,99,84,417,422
E5314,87,47,99,96,87,416,423
E5018,71,95,81,76,93,416,424
E5006,87,96,94,76,63,416,425
E0500,76,90,85,89,76,416,426
E4920,76,68,85,93,94,416,427
E1765,89,77,89,79,82,416,428
E4739,75,94,86,70,91,416,429
E8789,45,96,97,98,80,416,430
E3695,86,94,88,49,99,416,431
E3120,49,92,92,100,83,416,432
E7283,90,92,83,85,66,416,433
E1371,82,67,85,95,87,416,434
E9027,87,91,64,97,77,416,435
E1058,95,94,86,92,49,416,436
E6902,74,93,95,77,77,416,437
E9079,85,99,60,95,77,416,438
E7923,90,93,87,89,57,416,439
E6454,62,92,86,79,97,416,440
E0757,82,80,79,77,98,416,441
E8776,95,85,68,88,80,416,442
E3589,84,63,96,85,88,416,443
E3162,64,88,74,99,91,416,444
E6555,77,69,95,100,75,416,445
E6329,94,88,78,58,98,416,446
E9759,85,93,81,98,59,416,447
E6344,75,72,85,88,96,416,448
E1076,91,98,88,97,42,416,449
E4859,91,73,59,96,97,416,450
E2148,96,42,90,88,100,416,451
E7963,66,64,98,90,98,416,452
E4321,91,60,77,100,87,415,453
E3549,95,64,92,72,92,415,454
E8007,64,89,100,85,77,415,455
E1354,62,77,100,86,90,415,456
E1033,78,86,69,86,96,415,457
E0913,96,87,71,99,62,415,458
E6650,78,68,79,97,93,415,459
E1088,61,79,96,100,79,415,460
E6312,91,97,75,79,73,415,461
E6837,54,90,95,79,97,415,462
E4670,81,88,65,81,100,415,463
E4048,88,78,99,80,70,415,464
E4626,66,85,90,89,85,415,465
E8152,84,100,90,52,89,415,466
E3349,92,90,83,57,93,415,467
E2167,84,99,93,67,72,415,468
E2168,77,98,80,70,90,415,469
E7046,82,63,91,79,100,415,470
E4531,96,85,99,84,51,415,471
E6161,86,96,54,99,80,415,472
E0794,97,81,88,62,87,415,473
E0438,89,78,93,55,100,415,474
E2706,90,68,88,92,77,415,475
E6539,99,45,95,76,100,415,476
E3391,67,97,93,59,98,414,477
E1552,100,84,70,86,74,414,478
E5733,74,84,77,88,91,414,479
E1500,98,98,96,63,59,414,480
E8561,94,94,96,48,82,414,481
E8129,98,87,65,76,88,414,482
E3681,98,96,60,86,74,414,483
E6696,83,88,71,82,90,414,484
E1220,83,99,78,92,62,414,485
E4529,80,76,69,100,89,414,486
E0027,78,85,87,95,69,414,487
E4535,88,92,89,45,100,414,488
E9887,98,85,63,75,93,414,489
E8265,48,82,96,92,96,414,490
E6797,94,88,53,81,98,414,491
E4840,84,95,99,50,86,414,492
E2261,90,59,94,93,78,414,493
E9011,100,73,72,97,72,414,494
E3430,93,85,91,86,59,414,495
E3688,88,94,89,44,99,414,496
E4279,95,77,68,80,94,414,497
E8722,67,57,94,97,99,414,498
E0243,71,98,92,53,100,414,499
E1807,99,56,87,82,90,414,500
E9784,83,63,94,99,75,414,501
E5040,81,97,84,85,67,414,502
E7561,74,93,80,69,98,414,503
E1733,82,95,74,100,63,414,504
E2722,86,89,90,78,71,414,505
E9670,98,84,85,99,48,414,506
E3101,87,77,84,80,86,414,507
E6752,89,98,84,46,97,414,508
E2661,99,79,87,72,77,414,509
E9286,75,72,81,90,96,414,510
E2429,71,100,95,87,60,413,511
E7737,91,81,68,85,88,413,512
E3689,78,62,90,98,85,413,513
E6343,98,59,74,99,83,413,514
E3515,61,72,87,98,95,413,515
E3113,84,57,93,99,80,413,516
E1152,92,40,93,93,95,413,517
E1701,99,96,91,76,51,413,518
E3963,92,70,88,67,96,413,519
E7846,57,91,99,86,80,413,520
E7480,92,98,84,92,47,413,521
E3843,88,53,88,90,94,413,522
E2800,91,67,89,99,67,413,523
E3492,94,98,81,94,46,413,524
E7528,72,89,65,93,94,413,525
E2537,95,66,88,67,97,413,526
E2381,80,88,86,79,80,413,527
E9775,97,92,50,90,84,413,528
E6839,85,70,75,90,93,413,529
E2896,73,67,87,88,98,413,530
E7074,96,99,56,98,64,413,531
E5039,58,72,90,99,94,413,532
E6708,94,81,69,83,86,413,533
E5235,64,94,94,92,69,413,534
E8270,83,100,90,97,43,413,535
E2041,98,52,91,96,76,413,536
E4426,92,94,95,87,45,413,537
E2784,84,67,96,68,98,413,538
E8634,62,99,97,92,63,413,539
E3509,66,95,76,99,77,413,540
E3873,87,88,79,89,70,413,541
E1104,55,99,100,71,88,413,542
E4723,67,64,99,91,91,412,543
E7397,89,84,95,59,85,412,544
E2346,75,97,90,80,70,412,545
E2397,97,82,85,56,92,412,546
E1977,49,78,100,97,88,412,547
E3684,88,74,80,80,90,412,548
E6578,86,74,84,73,95,412,549
E2350,64,92,88,82,86,412,550
E1605,89,91,71,94,67,412,551
E4172,86,97,93,75,61,412,552
E5757,73,88,66,99,86,412,553
E8685,100,68,80,75,89,412,554
E0590,48,88,97,83,96,412,555
E0319,98,63,57,96,98,412,556
E7637,100,91,91,75,55,412,557
E4049,66,100,89,89,68,412,558
E2449,95,75,67,99,76,412,559
E2734,43,94,94,84,97,412,560
E1830,91,63,79,100,79,412,561
E7892,67,100,84,98,63,412,562
E3155,97,88,69,80,78,412,563
E9074,90,80,95,64,83,412,564
E8725,59,98,71,95,89,412,565
E7883,63,88,82,83,96,412,566
E5271,84,98,89,51,90,412,567
E0998,87,97,61,82,85,412,568
E6675,93,76,95,50,98,412,569
E1489,100,97,88,87,40,412,570
E9836,79,97,79,92,65,412,571
E3781,43,100,96,77,96,412,572
E2129,89,85,93,78,67,412,573
E9842,99,84,99,49,80,411,574
E0847,79,68,92,97,75,411,575
E5170,79,48,100,86,98,411,576
E7235,100,84,69,71,87,411,577
E1227,90,70,93,70,88,411,578
E4712,94,57,77,85,98,411,579
E3789,95,68,92,99,57,411,580
E6347,88,62,71,93,97,411,581
E0325,97,99,61,81,73,411,582
E7734,96,76,84,63,92,411,583
E0717,86,60,96,83,86,411,584
E3739,97,81,74,89,70,411,585
E4251,95,72,99,45,100,411,586
E8471,91,60,93,85,82,411,587
E7247,99,93,97,53,69,411,588
E5145,69,96,61,87,98,411,589
E8779,76,89,59,98,89,411,590
E7426,87,94,90,48,92,411,591
E6545,78,96,83,61,93,411,592
E8927,40,96,90,94,91,411,593
E1212,74,98,84,68,87,411,594
E3513,93,97,77,67,77,411,595
E6461,72,60,86,100,93,411,596
E7641,71,77,98,93,72,411,597
E0705,96,71,97,50,97,411,598
E5177,85,47,87,100,92,411,599
E7381,61,83,84,85,98,411,600
E6398,67,59,100,85,100,411,601
E8740,81,90,82,93,65,411,602
E8441,89,98,79,68,77,411,603
E6331,92,79,77,100,63,411,604
E9902,70,97,95,93,56,411,605
E1103,88,87,68,100,68,411,606
E1054,91,78,89,76,77,411,607
E9275,85,55,92,85,94,411,608
E5767,88,99,61,69,93,410,609
E4771,76,97,96,56,85,410,610
E1867,64,76,93,83,94,410,611
E4410,85,99,90,49,87,410,612
E1968,76,91,63,99,81,410,613
E1079,53,96,92,95,74,410,614
E7689,100,77,56,83,94,410,615
E4070,96,64,80,83,87,410,616
E0510,90,82,84,69,85,410,617
E4925,86,80,63,89,92,410,618
E7139,88,88,61,98,75,410,619
E0696,62,92,80,92,84,410,620
E1647,90,58,100,65,97,410,621
E6044,100,88,61,83,78,410,622
E7560,81,95,70,68,96,410,623
E9502,79,74,89,75,93,410,624
E9306,91,53,87,92,87,410,625
E8214,72,84,76,91,87,410,626
E3536,72,74,80,97,87,410,627
E4381,74,83,79,83,91,410,628
E2482,96,50,100,82,82,410,629
E0134,88,72,99,88,63,410,630
E9950,83,100,91,54,82,410,631
E2265,82,57,87,96,88,410,632
E5445,97,92,58,64,99,410,633
E5669,99,89,42,98,82,410,634
E0093,96,99,51,89,75,410,635
E1370,100,46,82,84,98,410,636
E6848,62,67,94,93,94,410,637
E9792,98,78,61,94,79,410,638
E4338,96,78,78,77,81,410,639
E1810,97,62,65,89,97,410,640
E6069,57,71,90,98,94,410,641
E2959,86,41,98,85,100,410,642
E5426,84,66,96,72,92,410,643
E4239,94,64,89,79,84,410,644
E4546,89,94,87,76,64,410,645
E4456,87,91,92,85,55,410,646
E5621,96,90,73,63,88,410,647
E8280,80,76,96,63,95,410,648
E2707,94,61,99,77,78,409,649
E9844,84,70,63,96,96,409,650
E4044,89,60,98,70,92,409,651
E1160,99,78,66,70,96,409,652
E6445,54,96,95,76,88,409,653
E5775,59,77,92,86,95,409,654
E2758,100,92,88,47,82,409,655
E5327,85,85,86,54,99,409,656
E0518,74,100,83,75,77,409,657
E7457,95,78,90,50,96,409,658
E5928,89,58,94,83,85,409,659
E8115,73,93,83,86,74,409,660
E6320,89,93,74,68,85,409,661
E9417,70,98,61,93,87,409,662
E4203,91,75,53,90,100,409,663
E8946,96,86,67,64,96,409,664
E4942,87,90,78,87,67,409,665
E5288,97,80,61,97,74,409,666
E9067,88,72,85,67,97,409,667
E0586,93,89,87,89,51,409,668
E3119,73,88,81,76,91,409,669
E8306,80,96,87,97,49,409,670
E8106,70,97,76,86,80,409,671
E0513,92,96,91,73,57,409,672
E1336,100,67,89,61,92,409,673
E6566,94,92,53,99,71,409,674
E0749,100,54,100,91,64,409,675
E2204,60,97,75,97,80,409,676
E2402,96,78,53,90,92,409,677
E0755,95,84,70,100,60,409,678
E3256,95,80,95,46,93,409,679
E7290,99,91,51,100,68,409,680
E5261,60,69,95,88,97,409,681
E1463,98,81,96,57,76,408,682
E3279,91,57,95,90,75,408,683
E5075,93,86,85,45,99,408,684
E5007,98,44,94,86,86,408,685
E3899,97,77,98,57,79,408,686
E6187,91,92,44,88,93,408,687
E5939,63,72,89,84,100,408,688
E1362,96,51,76,87,98,408,689
E9207,87,43,84,100,94,408,690
E0342,90,91,74,61,92,408,691
E0167,99,65,66,90,88,408,692
E2741,64,70,75,99,100,408,693
E7777,96,97,88,60,67,408,694
E8747,88,96,97,43,84,408,695
E7586,52,98,94,72,92,408,696
E3122,91,59,89,71,98,408,697
E5806,80,91,100,44,93,408,698
E2517,73,83,69,97,86,408,699
E2606,81,94,91,82,60,408,700
E2622,99,85,63,88,73,408,701
E9942,89,87,62,76,94,408,702
E7511,62,71,94,94,87,408,703
E0316,58,100,80,91,79,408,704
E9224,76,95,100,53,84,408,705
E9458,54,98,89,89,78,408,706
E8945,93,96,55,78,86,408,707
E7514,64,71,93,93,87,408,708
E5660,90,69,78,73,98,408,709
E6083,89,96,89,63,71,408,710
E8175,82,96,66,69,95,408,711
E0710,71,96,74,79,88,408,712
E4430,81,73,94,70,90,408,713
E6470,56,94,78,84,96,408,714
E9525,99,99,90,59,61,408,715
E4876,54,100,89,68,97,408,716
E5876,68,76,78,96,90,408,717
E6057,65,81,100,98,64,408,718
E6854,91,84,95,75,63,408,719
E8149,61,98,86,90,73,408,720
E9882,72,95,51,97,93,408,721
E3384,79,90,68,80,91,408,722
E6859,56,90,94,87,81,408,723
E8840,66,45,97,100,100,408,724
E8527,86,99,69,65,89,408,725
E7934,87,98,84,70,68,407,726
E6349,67,94,75,73,98,407,727
E1751,71,97,75,65,99,407,728
E7745,98,57,93,92,67,407,729
E5401,95,84,72,70,86,407,730
E6451,90,81,82,75,79,407,731
E0013,78,91,69,81,88,407,732
E3506,61,89,62,99,96,407,733
E8227,82,76,60,97,92,407,734
E6260,73,85,90,73,86,407,735
E6648,61,60,88,98,100,407,736
E5805,64,93,82,88,80,407,737
E2421,84,92,92,41,98,407,738
E7382,98,74,68,81,86,407,739
E1043,98,97,59,77,76,407,740
E4186,91,86,43,91,96,407,741
E7819,64,95,98,81,69,407,742
E9778,95,99,77,63,73,407,743
E3727,82,84,57,91,93,407,744
E7135,72,80,98,87,70,407,745
E1065,89,68,96,60,94,407,746
E5690,97,86,96,43,85,407,747
E8808,62,95,60,98,92,407,748
E0251,92,96,83,52,84,407,749
E6118,84,95,78,88,62,407,750
E5760,98,88,59,93,69,407,751
E5938,83,91,70,100,63,407,752
E3261,95,92,53,70,97,407,753
E6214,64,95,76,100,72,407,754
E3290,57,83,85,95,87,407,755
E6970,87,95,50,81,94,407,756
E4517,67,98,96,60,86,407,757
E4790,94,61,84,76,92,407,758
E5684,91,86,98,80,52,407,759
E9194,97,100,56,99,55,407,760
E5351,74,86,92,74,81,407,761
E4205,93,97,94,45,78,407,762
E0955,71,90,100,49,97,407,763
E3820,87,100,95,66,59,407,764
E1735,68,97,81,84,77,407,765
E0416,92,86,86,97,45,406,766
E8023,64,75,78,100,89,406,767
E9997,86,53,100,69,98,406,768
E5804,96,78,79,91,62,406,769
E7040,96,84,65,64,97,406,770
E4457,87,59,79,92,89,406,771
E4218,97,92,86,86,45,406,772
E0302,89,67,80,78,92,406,773
E1051,90,88,85,60,83,406,774
E7703,90,54,83,81,98,406,775
E9132,99,93,82,53,79,406,776
E1854,85,82,86,69,84,406,777
E7248,91,70,90,99,56,406,778
E1131,87,98,70,62,89,406,779
E3181,40,94,85,92,95,406,780
E0579,73,95,82,87,69,406,781
E5951,88,98,61,69,90,406,782
E6380,42,89,98,87,90,406,783
E3587,72,69,95,97,73,406,784
E7394,59,78,95,98,76,406,785
E2139,95,87,67,79,78,406,786
E8910,89,42,86,92,97,406,787
E5988,97,48,98,78,85,406,788
E3266,82,100,98,81,45,406,789
E2589,77,92,87,57,93,406,790
E9567,99,92,64,95,56,406,791
E4176,100,74,51,97,84,406,792
E2119,92,48,94,80,92,406,793
E7181,100,57,75,95,79,406,794
E1062,98,81,62,70,95,406,795
E5216,95,100,57,70,84,406,796
E8788,95,62,90,90,69,406,797
E8172,89,83,90,44,100,406,798
E7400,66,83,90,82,85,406,799
E9931,80,96,57,98,75,406,800
E3117,89,95,65,62,95,406,801
E2452,79,99,81,49,98,406,802
E4408,90,69,93,94,60,406,803
E3425,62,81,76,91,96,406,804
E1602,83,71,85,69,98,406,805
E7919,65,96,69,89,86,405,806
E0427,68,53,97,87,100,405,807
E6235,74,83,98,95,55,405,808
E9806,95,80,53,96,81,405,809
E8613,72,82,83,94,74,405,810
E7081,89,94,79,87,56,405,811
E1749,99,61,80,76,89,405,812
E8024,75,97,94,95,44,405,813
E6756,56,77,88,94,90,405,814
E8533,82,72,63,91,97,405,815
E0973,89,78,94,51,93,405,816
E6619,82,63,84,86,90,405,817
E8355,93,56,76,84,96,405,818
E9469,70,67,95,79,94,405,819
E3832,94,73,95,45,98,405,820
E2911,77,53,78,98,99,405,821
E2510,66,100,77,73,89,405,822
E3917,87,58,96,87,77,405,823
E7341,90,92,44,85,94,405,824
E2095,55,82,88,89,91,405,825
E4549,100,80,91,72,62,405,826
E3560,94,87,94,82,48,405,827
E7263,91,80,89,50,95,405,828
E9228,74,94,68,72,97,405,829
E1172,94,79,85,58,89,405,830
E0950,73,80,99,69,84,405,831
E2161,90,72,59,85,99,405,832
E4676,89,92,89,58,77,405,833
E8477,91,75,56,86,97,405,834
E2954,42,94,88,83,98,405,835
E6993,100,73,83,66,83,405,836
E4562,79,87,71,97,71,405,837
E2016,86,89,49,90,91,405,838
E5824,87,68,86,64,100,405,839
E5045,96,94,67,54,94,405,840
E6833,89,64,90,62,100,405,841
E7519,82,91,67,73,92,405,842
E4709,77,91,83,90,64,405,843
E5901,89,42,92,85,97,405,844
E0148,93,87,42,86,97,405,845
E0265,94,91,99,48,73,405,846
E1609,59,99,96,70,81,405,847
E6015,83,98,97,43,84,405,848
E7921,68,65,92,98,82,405,849
E5846,66,62,85,93,99,405,850
E4087,83,87,64,82,89,405,851
E0672,100,76,89,99,41,405,852
E3844,96,84,84,61,80,405,853
E1697,84,100,50,83,88,405,854
E2507,86,89,99,85,46,405,855
E4490,71,45,99,94,95,404,856
E6049,85,99,98,77,45,404,857
E3123,96,57,72,80,99,404,858
E4020,80,79,69,94,82,404,859
E1984,89,82,65,96,72,404,860
E8334,82,93,95,48,86,404,861
E4992,91,64,100,72,77,404,862
E6115,89,68,66,90,91,404,863
E2127,94,92,98,56,64,404,864
E8675,96,83,95,58,72,404,865
E9243,75,98,43,89,99,404,866
E5529,100,76,88,82,58,404,867
E9479,97,86,65,86,70,404,868
E3668,82,100,47,76,99,404,869
E1529,58,95,92,89,70,404,870
E2181,87,89,91,40,97,404,871
E9550,67,88,75,96,78,404,872
E1007,98,79,87,58,82,404,873
E9412,95,78,96,80,55,404,874
E7989,76,69,92,75,92,404,875
E5240,97,43,88,77,99,404,876
E6123,92,74,64,86,88,404,877
E8107,54,90,100,90,70,404,878
E8986,99,71,98,70,66,404,879
E2080,55,86,88,96,79,404,880
E9858,85,85,77,75,82,404,881
E5565,98,78,69,80,79,404,882
E8659,97,66,96,56,89,404,883
E7949,74,79,94,68,89,404,884
E7170,97,46,98,97,66,404,885
E5209,98,75,94,76,61,404,886
E4054,97,98,87,60,62,404,887
E0591,81,91,92,49,91,404,888
E9585,62,96,73,100,73,404,889
E1582,92,74,72,76,90,404,890
E8223,60,92,92,67,93,404,891
E8663,93,89,71,99,52,404,892
E2226,98,87,89,60,70,404,893
E2730,97,48,60,99,100,404,894
E3397,64,91,98,82,69,404,895
E1629,79,90,58,96,81,404,896
E5956,65,92,84,93,70,404,897
E0361,99,83,70,77,75,404,898
E7626,97,92,64,56,95,404,899
E0993,95,75,98,60,76,404,900
E1226,90,68,92,70,84,404,901
E5697,62,94,85,71,91,403,902
E6043,85,60,100,92,66,403,903
E4078,49,97,91,86,80,403,904
E3520,81,58,85,86,93,403,905
E1460,77,91,67,86,82,403,906
E6883,98,80,95,73,57,403,907
E2178,89,80,55,86,93,403,908
E2109,98,96,77,43,89,403,909
E0930,61,71,95,97,79,403,910
E7412,97,74,99,59,74,403,911
E8700,65,96,82,62,98,403,912
E3800,96,42,90,100,75,403,913
E8448,52,84,88,95,84,403,914
E3294,84,80,80,60,99,403,915
E1812,81,75,80,71,96,403,916
E0996,74,88,93,87,61,403,917
E2654,68,89,81,77,88,403,918
E3402,85,48,85,86,99,403,919
E9895,63,96,82,71,91,403,920
E1113,92,45,91,76,99,403,921
E7834,93,63,90,96,61,403,922
E6223,90,60,92,71,90,403,923
E8209,96,53,94,74,86,403,924
E6666,95,74,68,94,72,403,925
E9403,48,92,97,83,83,403,926
E2333,81,49,82,92,99,403,927
E4496,86,93,57,86,81,403,928
E1705,90,56,74,95,88,403,929
E4788,94,70,96,69,74,403,930
E8295,83,50,98,78,94,403,931
E9612,70,84,81,68,100,403,932
E6012,51,72,95,98,87,403,933
E0415,56,77,95,76,99,403,934
E7204,93,79,57,98,76,403,935
E3393,79,91,67,78,88,403,936
E1358,77,82,63,94,87,403,937
E6361,58,88,95,68,94,403,938
E3818,69,72,88,76,98,403,939
E6593,98,90,59,57,99,403,940
E7843,88,75,85,94,61,403,941
E3109,78,89,99,71,66,403,942
E1994,78,68,86,86,85,403,943
E2708,97,100,98,57,51,403,944
E4700,50,92,76,91,94,403,945
E2280,77,95,95,88,48,403,946
E8399,87,79,70,72,94,402,947
E3254,67,100,77,64,94,402,948
E0938,72,89,84,77,80,402,949
E8799,90,78,62,90,82,402,950
E6483,95,89,63,85,70,402,951
E6465,89,58,85,98,72,402,952
E9935,98,100,60,71,73,402,953
E4355,91,64,80,98,69,402,954
E3760,59,85,80,99,79,402,955
E8575,89,41,85,94,93,402,956
E1317,51,100,75,77,99,402,957
E7508,76,61,87,78,100,402,958
E5049,47,85,82,99,89,402,959
E0353,100,47,99,83,73,402,960
E5819,84,95,79,49,95,402,961
E7177,98,57,61,92,94,402,962
E8060,95,79,76,89,63,402,963
E9510,64,84,87,87,80,402,964
E5747,86,73,77,86,80,402,965
E5047,73,97,86,74,72,402,966
E9923,47,93,98,78,86,402,967
E0318,75,99,81,59,88,402,968
E4950,92,83,56,72,99,402,969
E6847,86,90,79,54,93,402,970
E1628,70,77,84,71,100,402,971
E4302,81,54,93,75,99,402,972
E8763,42,98,87,86,89,402,973
E3715,88,92,70,80,72,402,974
E2445,98,99,60,61,84,402,975
E1875,76,97,79,53,97,402,976
E5126,82,94,76,97,53,402,977
E6936,68,91,93,95,55,402,978
E9282,100,98,45,92,67,402,979
E8991,63,87,88,86,78,402,980
E0535,67,60,99,93,83,402,981
E7228,90,44,100,74,94,402,982
E8847,77,93,76,63,93,402,983
E2417,78,97,78,92,57,402,984
E9482,57,92,97,81,75,402,985
E4995,87,97,84,43,91,402,986
E3206,91,69,90,87,64,401,987
E4862,88,97,81,73,62,401,988
E9454,59,97,90,78,77,401,989
E8286,89,72,87,54,99,401,990
E1822,95,92,57,80,77,401,991
E9879,77,88,85,96,55,401,992
E3054,100,52,86,78,85,401,993
E4339,80,88,46,89,98,401,994
E4006,92,69,69,81,90,401,995
E1909,100,59,81,93,68,401,996
E3488,85,82,78,65,91,401,997
E3281,86,91,72,60,92,401,998
E9732,88,97,73,48,95,401,999
E0890,89,54,73,98,87,401,1000
E6765,100,74,89,49,89,401,1001
E8982,96,82,82,95,46,401,1002
E7704,87,97,80,92,45,401,1003
E2475,40,100,77,99,85,401,1004
E1044,68,98,72,70,93,401,1005
E3787,52,98,96,98,57,401,1006
E0664,92,79,100,64,66,401,1007
E5629,47,88,86,100,80,401,1008
E8543,98,91,68,50,94,401,1009
E9606,91,88,56,98,68,401,1010
E8404,83,65,98,63,92,401,1011
E1251,89,92,90,76,54,401,1012
E0734,97,96,53,83,72,401,1013
E7546,99,68,65,84,85,401,1014
E4187,59,68,95,96,83,401,1015
E3793,78,87,59,81,96,401,1016
E3538,45,97,91,68,100,401,1017
E9038,91,77,84,60,89,401,1018
E1666,75,95,71,60,100,401,1019
E3921,90,89,78,50,94,401,1020
E7002,87,66,97,92,59,401,1021
E7185,57,86,94,68,96,401,1022
E6751,50,80,84,92,95,401,1023
E8133,96,51,94,84,76,401,1024
E1521,49,98,77,99,78,401,1025
E9676,92,100,92,53,64,401,1026
E4675,96,44,85,98,77,400,1027
E5744,51,89,80,83,97,400,1028
E3495,89,72,63,84,92,400,1029
E8567,66,95,74,95,70,400,1030
E9361,72,98,94,81,55,400,1031
E7238,52,92,78,86,92,400,1032
E8402,94,89,67,84,66,400,1033
E5541,84,49,94,73,100,400,1034
E5002,98,73,74,63,92,400,1035
E6799,91,98,72,50,89,400,1036
E8706,99,53,94,59,95,400,1037
E4312,77,97,86,59,81,400,1038
E6283,70,97,53,91,89,400,1039
E9708,62,95,78,74,91,400,1040
E9735,60,84,77,80,99,400,1041
E7092,97,73,78,66,86,400,1042
E5826,82,86,73,68,91,400,1043
E5140,93,57,70,82,98,400,1044
E8510,49,84,97,95,75,400,1045
E9984,82,49,95,87,87,400,1046
E2124,98,97,76,85,44,400,1047
E0077,80,100,84,81,55,400,1048
E7852,78,95,80,89,58,400,1049
E0534,49,91,91,71,98,400,1050
E2860,59,99,99,71,72,400,1051
E5949,59,75,92,80,94,400,1052
E1250,81,96,79,70,74,400,1053
E7276,94,67,67,83,89,400,1054
E2876,96,47,96,83,78,400,1055
E9524,85,87,98,44,86,400,1056
E6466,57,84,60,99,100,400,1057
E5680,68,80,93,82,77,400,1058
E3161,97,88,55,91,69,400,1059
E9144,55,73,79,94,99,400,1060
E4814,78,82,70,87,83,400,1061
E4913,99,86,92,67,56,400,1062
E1793,81,65,74,80,100,400,1063
E9001,66,75,85,82,92,400,1064
E0610,91,75,86,77,71,400,1065
E4329,56,60,96,90,98,400,1066
E4035,96,96,64,59,85,400,1067
E8048,100,96,61,80,63,400,1068
E7710,80,98,81,51,90,400,1069
E9940,66,63,85,95,91,400,1070
E0050,97,52,86,85,79,399,1071
E5614,93,77,97,76,56,399,1072
E8087,88,95,79,65,72,399,1073
E1430,92,57,57,93,100,399,1074
E0296,86,85,89,66,73,399,1075
E1879,71,80,81,87,80,399,1076
E8035,93,70,55,100,81,399,1077
E5725,45,88,100,96,70,399,1078
E2245,96,72,76,82,73,399,1079
E3948,92,86,98,52,71,399,1080
E2317,100,91,54,62,92,399,1081
E5818,87,98,62,67,85,399,1082
E6473,72,98,98,46,85,399,1083
E7983,82,85,82,57,93,399,1084
E7536,61,85,89,72,92,399,1085
E5301,95,55,78,86,85,399,1086
E1117,94,53,94,69,89,399,1087
E4559,42,92,100,70,95,399,1088
E1214,45,83,96,82,93,399,1089
E7197,89,99,42,94,75,399,1090
E9370,97,74,90,77,61,399,1091
E0972,93,86,73,67,80,399,1092
E6544,63,89,94,78,75,399,1093
E3625,79,79,91,84,66,399,1094
E4805,84,86,85,93,51,399,1095
E7565,93,94,46,89,77,399,1096
E7540,69,83,78,85,84,399,1097
E5564,71,74,59,98,97,399,1098
E8101,79,50,91,79,100,399,1099
E1429,97,74,97,41,90,399,1100
E8891,97,58,62,93,89,399,1101
E8001,96,96,62,54,91,399,1102
E2252,84,99,63,75,78,399,1103
E7695,93,59,68,82,97,399,1104
E9153,77,80,79,86,77,399,1105
E1368,89,88,75,98,49,399,1106
E6886,62,97,94,88,58,399,1107
E1157,72,76,53,98,100,399,1108
E2895,79,90,82,66,82,399,1109
E1194,48,94,81,79,97,399,1110
E6475,82,99,91,58,69,399,1111
E7858,95,60,90,91,63,399,1112
E7622,99,87,86,70,57,399,1113
E0032,91,79,64,78,86,398,1114
E9860,69,66,69,98,96,398,1115
E4713,76,83,73,88,78,398,1116
E4326,91,77,92,70,68,398,1117
E7389,81,80,97,66,74,398,1118
E9415,93,77,99,79,50,398,1119
E3424,98,97,76,73,54,398,1120
E5703,99,87,95,49,68,398,1121
E3019,74,89,90,100,45,398,1122
E7163,87,71,91,89,60,398,1123
E6423,58,97,91,63,89,398,1124
E4785,62,97,100,49,90,398,1125
E9069,89,97,89,64,59,398,1126
E3848,83,70,72,90,83,398,1127
E3999,83,69,99,74,73,398,1128
E2712,94,75,85,85,59,398,1129
E4301,92,64,86,61,95,398,1130
E2185,85,89,44,87,93,398,1131
E9796,82,90,57,72,97,398,1132
E2572,56,72,80,94,96,398,1133
E7814,62,89,92,59,96,398,1134
E8880,75,76,56,98,93,398,1135
E3768,61,53,98,100,86,398,1136
E6038,72,82,94,75,75,398,1137
E3018,96,74,83,85,60,398,1138
E5619,100,86,75,49,88,398,1139
E9179,88,49,100,72,89,398,1140
E9324,91,81,91,90,45,398,1141
E5391,54,94,79,99,72,398,1142
E3584,80,92,52,80,94,398,1143
E2629,44,89,100,79,86,398,1144
E2503,69,96,91,56,86,398,1145
E3786,90,97,62,100,49,398,1146
E4291,59,100,90,87,62,398,1147
E8641,98,90,52,94,64,398,1148
E1781,86,91,57,96,68,398,1149
E5438,53,90,79,89,87,398,1150
E8268,90,82,90,89,46,397,1151
E0276,59,87,87,87,77,397,1152
E7304,72,77,84,91,73,397,1153
E0310,80,59,91,78,89,397,1154
E8958,81,90,67,80,79,397,1155
E2232,68,93,86,70,80,397,1156
E2130,78,67,98,88,66,397,1157
E7119,94,90,72,62,79,397,1158
E6901,98,88,94,44,73,397,1159
E5213,96,68,88,89,56,397,1160
E6114,68,63,86,99,81,397,1161
E1510,63,56,80,98,100,397,1162
E4075,94,79,92,58,74,397,1163
E9052,92,83,52,97,73,397,1164
E8774,73,82,69,96,77,397,1165
E5992,94,54,91,84,74,397,1166
E3331,69,83,69,88,88,397,1167
E0172,97,83,78,79,60,397,1168
E2921,100,96,85,66,50,397,1169
E1027,76,93,71,70,87,397,1170
E7427,89,100,69,71,68,397,1171
E5802,73,94,48,98,84,397,1172
E8296,82,82,98,40,95,397,1173
E4653,97,52,78,100,70,397,1174
E0116,86,46,96,84,85,397,1175
E7112,87,49,98,77,86,397,1176
E6480,73,65,84,99,76,397,1177
E8143,49,89,81,79,99,397,1178
E9659,48,90,80,84,95,397,1179
E5411,75,64,93,96,69,397,1180
E6171,97,89,81,65,65,397,1181
E7838,82,91,93,89,42,397,1182
E0062,83,94,99,61,60,397,1183
E7346,82,57,91,92,75,397,1184
E8965,91,85,88,40,93,397,1185
E2819,88,83,76,63,87,397,1186
E2379,94,79,55,84,85,397,1187
E2400,76,91,99,78,53,397,1188
E6233,96,80,88,49,84,397,1189
E1218,58,89,64,96,90,397,1190
E4188,79,96,89,78,55,397,1191
E4736,100,77,97,55,68,397,1192
E7747,65,47,99,89,97,397,1193
E3100,74,89,89,87,58,397,1194
E6238,86,66,79,80,86,397,1195
E4258,81,79,66,85,86,397,1196
E2122,59,75,100,86,77,397,1197
E9538,68,89,79,62,99,397,1198
E5428,71,91,83,95,57,397,1199
E5671,70,54,89,96,88,397,1200
E8618,76,66,83,90,82,397,1201
E0323,61,87,76,95,78,397,1202
E0037,67,92,74,74,90,397,1203
E4746,81,69,100,83,64,397,1204
E5146,95,78,79,60,84,396,1205
E9870,99,90,96,71,40,396,1206
E0952,87,67,83,64,95,396,1207
E3898,75,94,75,94,58,396,1208
E9661,81,55,83,94,83,396,1209
E9696,43,96,98,86,73,396,1210
E7468,76,98,84,91,47,396,1211
E4210,92,73,52,91,88,396,1212
E6960,95,98,57,75,71,396,1213
E3677,90,91,66,72,77,396,1214
E7043,97,44,91,85,79,396,1215
E6614,98,90,65,54,89,396,1216
E7431,53,94,90,65,94,396,1217
E5182,45,100,95,75,81,396,1218
E7205,91,98,73,86,48,396,1219
E8437,91,60,87,65,93,396,1220
E4105,88,93,41,89,85,396,1221
E6863,86,87,73,59,91,396,1222
E5484,94,56,64,91,91,396,1223
E8298,86,72,78,66,94,396,1224
E1008,97,42,80,83,94,396,1225
E8394,88,92,90,54,72,396,1226
E1417,88,58,95,100,55,396,1227
E4524,60,91,96,72,77,396,1228
E9599,71,89,75,100,61,396,1229
E9705,85,48,96,76,91,396,1230
E0640,85,65,78,70,98,396,1231
E2888,81,76,91,61,87,396,1232
E1019,81,98,52,67,98,396,1233
E6197,68,89,96,84,59,396,1234
E7947,93,84,60,95,64,396,1235
E9330,76,53,80,100,87,396,1236
E0506,41,96,95,89,75,396,1237
E1509,72,53,96,79,96,396,1238
E1179,77,99,62,61,97,396,1239
E6006,86,90,48,75,97,396,1240
E5345,80,99,63,95,59,396,1241
E8123,63,65,76,97,95,396,1242
E0889,93,56,83,78,86,396,1243
E0608,79,69,84,89,75,396,1244
E7369,62,88,51,96,99,396,1245
E6861,87,73,100,76,60,396,1246
E4813,91,54,100,55,96,396,1247
E0919,62,70,100,75,89,396,1248
E7472,83,51,97,84,81,396,1249
E8500,99,45,98,64,89,395,1250
E3886,94,100,86,40,75,395,1251
E4847,71,84,64,76,100,395,1252
E6408,94,68,63,70,100,395,1253
E3477,59,98,64,97,77,395,1254
E8163,85,46,98,96,70,395,1255
E8901,82,90,78,59,86,395,1256
E0234,80,100,92,49,74,395,1257
E4366,85,91,83,75,61,395,1258
E8242,88,70,77,71,89,395,1259
E6029,88,92,90,56,69,395,1260
E6403,99,81,56,65,94,395,1261
E1519,85,54,79,92,85,395,1262
E6567,96,89,63,64,83,395,1263
E4214,81,84,91,47,92,395,1264
E6908,92,75,78,57,93,395,1265
E6395,93,64,88,81,69,395,1266
E8775,99,86,67,63,80,395,1267
E0043,73,88,49,99,86,395,1268
E5248,62,78,96,69,90,395,1269
E8955,98,70,68,82,77,395,1270
E9848,75,90,79,82,69,395,1271
E0617,96,93,80,55,71,395,1272
E8622,82,53,62,99,99,395,1273
E4297,85,73,58,93,86,395,1274
E4217,97,77,44,92,85,395,1275
E9145,92,95,73,60,75,395,1276
E7214,99,79,57,82,78,395,1277
E6850,53,92,95,74,81,395,1278
E4830,92,73,100,48,82,395,1279
E7791,93,91,74,44,93,395,1280
E4036,73,76,99,72,75,395,1281
E8551,97,47,98,66,87,395,1282
E3578,87,77,87,44,100,395,1283
E0685,87,95,47,72,94,395,1284
E8220,66,90,58,100,81,395,1285
E3280,78,79,91,93,54,395,1286
E0468,93,66,87,69,80,395,1287
E4780,68,75,92,100,60,395,1288
E7489,96,56,92,73,78,395,1289
E2725,40,96,97,100,62,395,1290
E8687,74,63,99,78,81,395,1291
E9616,86,100,76,87,46,395,1292
E6842,84,71,89,94,57,395,1293
E5291,95,83,65,76,76,395,1294
E8617,92,60,65,84,94,395,1295
E7805,95,100,65,44,91,395,1296
E5278,63,73,90,79,90,395,1297
E0328,98,99,63,57,78,395,1298
E5960,65,65,92,94,79,395,1299
E4209,74,82,98,73,68,395,1300
E4058,92,64,58,95,86,395,1301
E6561,78,57,74,90,96,395,1302
E8830,83,85,78,54,95,395,1303
E2684,92,81,85,53,84,395,1304
E6776,67,98,85,77,68,395,1305
E9134,95,85,74,80,61,395,1306
E9787,81,66,76,79,93,395,1307
E8648,90,49,90,82,84,395,1308
E9622,58,49,98,100,90,395,1309
E5104,90,100,57,64,84,395,1310
E4183,76,76,48,97,97,394,1311
E7697,60,91,100,46,97,394,1312
E1759,57,90,89,96,62,394,1313
E9480,40,94,68,95,97,394,1314
E2060,89,95,50,81,79,394,1315
E9463,60,93,63,80,98,394,1316
E2008,74,99,53,90,78,394,1317
E1973,46,98,95,77,78,394,1318
E7232,95,94,88,65,52,394,1319
E0788,74,96,79,68,77,394,1320
E7082,45,72,95,84,98,394,1321
E4767,75,79,96,64,80,394,1322
E6785,96,57,62,79,100,394,1323
E0261,68,66,98,81,81,394,1324
E2406,97,53,88,67,89,394,1325
E8849,49,84,90,82,89,394,1326
E4846,98,72,87,94,43,394,1327
E7268,63,94,78,62,97,394,1328
E2987,96,44,87,97,70,394,1329
E0238,88,82,73,57,94,394,1330
E5416,64,99,91,88,52,394,1331
E1006,77,54,91,76,96,394,1332
E3498,86,63,83,100,62,394,1333
E4646,93,78,63,89,71,394,1334
E1261,74,100,85,59,76,394,1335
E3610,57,97,89,58,93,394,1336
E6413,96,61,43,95,99,394,1337
E2558,44,93,98,63,96,394,1338
E2447,98,86,61,77,72,394,1339
E9635,82,77,99,59,77,394,1340
E6652,85,77,56,88,88,394,1341
E6148,71,81,78,75,89,394,1342
E6968,80,95,67,92,60,394,1343
E3339,86,46,96,100,66,394,1344
E9467,85,79,85,98,47,394,1345
E2723,64,85,91,83,71,394,1346
E3696,87,55,63,92,97,394,1347
E0937,82,100,65,99,48,394,1348
E6458,90,82,55,72,95,394,1349
E1092,92,95,91,59,57,394,1350
E6992,99,60,99,93,43,394,1351
E5831,76,91,82,77,68,394,1352
E2752,72,100,99,49,74,394,1353
E6489,56,84,95,98,61,394,1354
E2796,98,93,46,100,57,394,1355
E2310,81,98,93,49,73,394,1356
E0424,65,82,91,98,58,394,1357
E7244,100,82,61,53,98,394,1358
E1190,69,93,86,53,93,394,1359
E9430,92,85,61,57,99,394,1360
E7785,77,73,73,95,76,394,1361
E0313,68,90,56,80,100,394,1362
E6153,52,80,98,76,88,394,1363
E6664,89,100,82,63,60,394,1364
E6336,96,84,55,64,95,394,1365
E8476,58,85,99,57,95,394,1366
E2046,84,74,61,77,98,394,1367
E4200,77,56,100,95,66,394,1368
E8240,66,78,82,79,89,394,1369
E7222,76,99,43,90,86,394,1370
E1496,44,91,97,81,80,393,1371
E2516,98,71,74,98,52,393,1372
E9023,41,86,100,79,87,393,1373
E8456,78,67,89,80,79,393,1374
E6432,41,81,97,86,88,393,1375
E1168,79,71,97,71,75,393,1376
E5450,87,95,62,55,94,393,1377
E2386,83,55,95,95,65,393,1378
E4643,57,90,88,79,79,393,1379
E6456,64,99,96,40,94,393,1380
E9824,89,97,90,50,67,393,1381
E6568,70,88,74,81,80,393,1382
E3870,69,79,89,68,88,393,1383
E1567,88,79,78,83,65,393,1384
E1232,86,86,72,73,76,393,1385
E6051,75,66,95,95,62,393,1386
E1720,94,92,75,60,72,393,1387
E6086,93,91,51,76,82,393,1388
E4568,86,68,73,90,76,393,1389
E1455,48,72,99,77,97,393,1390
E7421,69,85,73,90,76,393,1391
E2581,86,54,83,87,83,393,1392
E5310,77,83,95,41,97,393,1393
E3432,51,91,99,90,62,393,1394
E9193,87,86,68,60,92,393,1395
E8191,85,68,88,98,54,393,1396
E5439,56,64,87,98,88,393,1397
E9149,69,76,100,94,54,393,1398
E9045,99,87,77,81,49,393,1399
E0407,95,98,83,46,71,393,1400
E2737,55,86,81,80,91,393,1401
E9063,68,72,86,73,94,393,1402
E3542,100,71,77,65,80,393,1403
E2906,64,56,98,94,81,393,1404
E6919,51,91,74,77,100,393,1405
E0960,75,80,52,99,87,393,1406
E5794,100,72,100,43,78,393,1407
E2049,100,76,40,88,89,393,1408
E2251,83,77,79,89,65,393,1409
E6370,88,51,100,54,100,393,1410
E2813,83,63,56,94,97,393,1411
E2592,96,85,58,91,63,393,1412
E0767,52,80,89,87,85,393,1413
E3505,86,68,63,98,78,393,1414
E4253,97,85,74,47,90,393,1415
E0631,67,72,91,97,66,393,1416
E5396,63,63,80,99,88,393,1417
E0081,80,84,100,41,88,393,1418
E7051,97,78,94,40,84,393,1419
E2666,62,93,68,70,100,393,1420
E5929,94,57,70,94,78,393,1421
E5871,97,88,60,73,75,393,1422
E6421,71,97,64,87,74,393,1423
E5835,45,86,99,78,85,393,1424
E3242,70,82,50,93,98,393,1425
E3484,56,87,79,86,85,393,1426
E1590,93,54,69,87,90,393,1427
E2448,93,82,80,87,51,393,1428
E1046,84,90,78,98,43,393,1429
E3773,80,96,70,71,76,393,1430
E1681,57,95,98,55,88,393,1431
E9418,62,65,84,84,98,393,1432
E0970,66,85,98,86,58,393,1433
E8563,97,69,91,55,81,393,1434
E3127,78,88,83,75,69,393,1435
E5322,97,83,74,74,65,393,1436
E8628,85,98,82,84,44,393,1437
E7291,62,75,65,93,97,392,1438
E6013,62,56,86,99,89,392,1439
E1375,98,97,61,45,91,392,1440
E9586,81,94,51,97,69,392,1441
E1285,54,85,93,73,87,392,1442
E8081,95,62,60,82,93,392,1443
E8602,74,96,54,97,71,392,1444
E0332,75,100,75,84,58,392,1445
E9962,78,82,82,58,92,392,1446
E2658,72,79,84,61,96,392,1447
E9240,84,93,53,86,76,392,1448
E6041,81,85,49,85,92,392,1449
E8478,93,78,75,72,74,392,1450
E2444,98,80,84,64,66,392,1451
E2496,89,63,75,67,98,392,1452
E1950,90,77,98,82,45,392,1453
E5373,94,74,65,98,61,392,1454
E5155,78,93,40,88,93,392,1455
E4356,83,73,83,76,77,392,1456
E3804,98,70,94,90,40,392,1457
E9794,100,49,87,58,98,392,1458
E9627,65,65,84,87,91,392,1459
E8784,100,93,93,63,43,392,1460
E4171,74,94,89,92,43,392,1461
E7798,95,83,73,93,48,392,1462
E9862,85,85,82,49,91,392,1463
E1702,92,55,95,75,75,392,1464
E1813,65,83,97,88,59,392,1465
E8067,96,66,91,63,76,392,1466
E5316,95,89,62,79,67,392,1467
E2904,45,77,89,89,92,392,1468
E7775,52,70,99,97,74,392,1469
E5973,92,81,66,94,59,392,1470
E3730,91,75,87,61,78,392,1471
E3344,77,52,92,97,74,392,1472
E2427,99,50,72,79,92,392,1473
E2067,72,55,94,86,85,392,1474
E3570,89,73,67,73,90,392,1475
E3251,90,57,87,64,94,392,1476
E5924,52,100,54,93,93,392,1477
E7442,66,82,83,68,93,392,1478
E9114,49,95,74,80,94,392,1479
E5869,94,43,76,80,99,392,1480
E7771,99,94,58,54,87,392,1481
E7978,95,41,75,99,82,392,1482
E4894,61,100,68,67,96,392,1483
E0702,100,51,80,75,86,392,1484
E5567,53,77,91,99,72,392,1485
E5859,100,41,79,74,98,392,1486
E9568,99,51,68,100,74,392,1487
E2203,59,46,96,97,94,392,1488
E4220,91,86,63,74,78,392,1489
E0402,81,98,84,63,66,392,1490
E1948,93,85,51,67,96,392,1491
E2580,80,90,84,49,89,392,1492
E6585,96,51,84,75,86,392,1493
E5815,40,96,89,85,82,392,1494
E0647,81,71,98,42,100,392,1495
E5346,54,65,94,87,92,392,1496
E4834,56,82,78,96,80,392,1497
E9206,81,82,92,91,46,392,1498
E9623,56,84,93,91,68,392,1499
E7280,46,75,93,82,95,391,1500
E0570,90,69,80,81,71,391,1501
E3752,75,60,68,98,90,391,1502
E9755,68,78,74,91,80,391,1503
E4853,67,99,51,83,91,391,1504
E1323,83,77,94,67,70,391,1505
E4391,89,85,70,80,67,391,1506
E2791,86,76,75,92,62,391,1507
E1040,83,49,70,90,99,391,1508
E4394,85,78,65,76,87,391,1509
E7948,43,80,86,95,87,391,1510
E8811,64,88,89,51,99,391,1511
E0512,69,91,62,89,80,391,1512
E2766,80,86,78,100,47,391,1513
E1663,58,94,52,95,92,391,1514
E0645,41,92,82,92,84,391,1515
E7679,69,98,53,72,99,391,1516
E9406,56,96,79,91,69,391,1517
E2358,79,93,54,99,66,391,1518
E7663,51,71,80,97,92,391,1519
E4651,92,92,48,83,76,391,1520
E1942,66,89,70,73,93,391,1521
E4486,69,74,55,94,99,391,1522
E4627,56,92,84,92,67,391,1523
E9002,97,67,87,57,83,391,1524
E5435,70,78,84,88,71,391,1525
E5997,74,59,69,91,98,391,1526
E4658,54,85,89,68,95,391,1527
E5735,97,55,97,48,94,391,1528
E6798,97,51,79,76,88,391,1529
E7446,68,93,85,70,75,391,1530
E6412,96,97,98,44,56,391,1531
E5120,93,81,79,96,42,391,1532
E6889,53,53,91,95,99,391,1533
E4652,44,74,92,100,81,391,1534
E8084,79,85,94,76,57,391,1535
E7312,83,50,92,83,83,391,1536
E8184,43,90,97,66,95,391,1537
E8831,93,77,71,80,70,391,1538
E4028,91,85,88,65,62,391,1539
E4468,62,82,100,87,60,391,1540
E1379,87,74,81,49,100,391,1541
E6527,73,100,62,86,70,391,1542
E1704,83,80,86,62,80,391,1543
E7911,85,93,84,51,78,391,1544
E2552,81,98,53,78,81,391,1545
E4515,84,82,97,51,77,391,1546
E4602,97,75,45,88,86,391,1547
E6933,79,95,82,63,72,391,1548
E8341,62,99,88,59,83,391,1549
E2435,97,98,63,82,51,391,1550
E6784,75,96,93,51,76,391,1551
E2316,98,73,100,68,52,391,1552
E6651,100,81,94,66,50,391,1553
E6266,99,65,54,75,98,391,1554
E0017,75,49,90,100,77,391,1555
E5476,86,96,66,64,79,391,1556
E8353,58,97,87,89,60,391,1557
E6584,76,80,65,82,88,391,1558
E1556,76,100,42,74,99,391,1559
E6365,89,98,78,61,65,391,1560
E6146,94,83,92,43,79,391,1561
E0747,46,90,83,95,77,391,1562
E8453,88,85,74,80,64,391,1563
E8940,68,79,58,100,86,391,1564
E9310,78,55,99,83,76,391,1565
E4024,98,82,58,73,80,391,1566
E4659,61,94,96,55,85,391,1567
E1723,66,97,84,64,80,391,1568
E8956,96,53,88,64,90,391,1569
E7091,57,83,82,87,82,391,1570
E8088,91,82,53,71,94,391,1571
E6407,97,76,83,62,73,391,1572
E6453,42,99,62,98,90,391,1573
E1173,86,73,96,87,49,391,1574
E0070,92,78,90,82,49,391,1575
E7826,91,79,82,81,57,390,1576
E0862,74,94,84,84,54,390,1577
E4705,71,67,79,95,78,390,1578
E3809,81,64,94,86,65,390,1579
E8741,92,100,81,50,67,390,1580
E9209,80,60,99,65,86,390,1581
E5844,53,90,88,81,78,390,1582
E0188,69,82,69,78,92,390,1583
E5034,93,95,50,75,77,390,1584
E6987,57,91,95,76,71,390,1585
E9068,91,76,85,58,80,390,1586
E6105,54,52,100,99,85,390,1587
E6808,73,93,97,54,73,390,1588
E4623,97,78,63,96,56,390,1589
E3788,98,85,61,57,89,390,1590
E2956,85,97,41,87,80,390,1591
E7534,78,97,72,65,78,390,1592
E7466,71,96,85,98,40,390,1593
E7202,94,51,97,88,60,390,1594
E8314,97,64,67,79,83,390,1595
E9517,76,89,95,83,47,390,1596
E9867,87,96,59,77,71,390,1597
E6291,74,91,89,82,54,390,1598
E7941,99,62,78,68,83,390,1599
E2775,54,100,59,91,86,390,1600
E2671,86,76,90,81,57,390,1601
E4069,67,91,86,77,69,390,1602
E7376,75,75,79,92,69,390,1603
E8733,52,91,81,84,82,390,1604
E9688,69,85,66,98,72,390,1605
E7486,92,73,80,94,51,390,1606
E9798,89,91,90,57,63,390,1607
E7647,100,72,70,52,96,390,1608
E3269,94,79,52,70,95,390,1609
E7343,77,90,77,89,57,390,1610
E8557,89,54,89,92,66,390,1611
E4924,83,94,70,64,79,390,1612
E7216,81,74,99,62,74,390,1613
E9672,78,88,80,64,80,390,1614
E1797,81,77,77,69,86,390,1615
E1776,90,77,91,72,60,390,1616
E4021,77,66,98,92,57,390,1617
E2160,97,91,99,60,43,390,1618
E2430,87,93,92,49,69,390,1619
E1670,98,85,78,62,67,390,1620
E2757,83,79,68,80,80,390,1621
E9013,80,94,88,54,74,390,1622
E1312,93,95,65,59,78,390,1623
E5415,53,97,87,71,82,390,1624
E9172,75,100,83,86,46,390,1625
E2231,69,98,98,59,66,390,1626
E3134,97,87,98,55,53,390,1627
E1659,94,99,70,85,42,390,1628
E9212,85,76,72,57,100,390,1629
E1381,100,70,90,41,89,390,1630
E0981,75,87,52,86,90,390,1631
E2479,84,86,53,84,83,390,1632
E7606,75,72,66,98,79,390,1633
E0681,85,58,47,100,100,390,1634
E2700,97,56,64,80,93,390,1635
E5157,93,44,97,88,68,390,1636
E1719,77,58,89,83,83,390,1637
E3328,80,69,59,91,91,390,1638
E4706,100,63,70,57,100,390,1639
E1958,56,85,74,85,89,389,1640
E0552,73,80,98,79,59,389,1641
E6525,93,74,79,97,46,389,1642
E5850,86,83,79,51,90,389,1643
E7089,76,99,63,57,94,389,1644
E1210,79,68,70,85,87,389,1645
E3914,86,84,87,69,63,389,1646
E8079,94,87,88,48,72,389,1647
E6988,86,93,67,75,68,389,1648
E1148,45,99,80,76,89,389,1649
E0669,69,86,78,67,89,389,1650
E7145,73,70,93,58,95,389,1651
E9438,97,84,64,98,46,389,1652
E1805,59,67,90,83,90,389,1653
E1174,89,56,81,78,85,389,1654
E6117,76,92,73,71,77,389,1655
E2370,92,86,77,70,64,389,1656
E2967,43,92,60,94,100,389,1657
E7061,85,71,53,83,97,389,1658
E4308,75,76,94,85,59,389,1659
E1691,60,77,76,76,100,389,1660
E1769,85,83,95,69,57,389,1661
E7241,68,88,73,64,96,389,1662
E6612,74,74,61,96,84,389,1663
E8807,75,94,100,52,68,389,1664
E4574,96,55,86,86,66,389,1665
E1053,80,79,97,62,71,389,1666
E3771,79,42,95,95,78,389,1667
E5138,50,86,72,97,84,389,1668
E4543,94,80,78,79,58,389,1669
E9709,76,81,81,94,57,389,1670
E0571,79,77,100,66,67,389,1671
E6150,43,93,68,86,99,389,1672
E5722,100,83,49,74,83,389,1673
E8226,55,78,85,100,71,389,1674
E5667,54,61,99,96,79,389,1675
E0520,72,76,57,99,85,389,1676
E8619,85,71,60,99,74,389,1677
E4199,70,99,52,84,84,389,1678
E9747,55,97,73,95,69,389,1679
E5582,60,92,62,95,80,389,1680
E3284,86,87,49,78,89,389,1681
E5904,92,58,86,53,100,389,1682
E5979,94,78,65,53,99,389,1683
E8525,72,46,93,87,91,389,1684
E0769,94,93,66,86,50,389,1685
E9849,51,72,92,76,98,389,1686
E9032,96,64,75,73,81,389,1687
E0922,91,75,78,78,67,389,1688
E5402,60,85,94,93,57,389,1689
E5841,100,72,81,78,58,389,1690
E6629,81,78,89,82,59,389,1691
E2369,83,87,79,88,52,389,1692
E0706,72,98,46,74,99,389,1693
E1241,55,99,95,51,89,389,1694
E6304,91,95,47,64,92,389,1695
E7854,57,92,76,100,64,389,1696
E8916,81,83,86,85,54,389,1697
E7591,92,64,85,75,73,389,1698
E5363,56,91,95,60,87,389,1699
E5936,92,60,79,63,95,389,1700
E2431,51,84,88,78,88,389,1701
E5175,74,80,55,94,86,389,1702
E9876,68,89,71,83,78,389,1703
E5931,56,93,92,53,95,389,1704
E1516,99,59,96,60,75,389,1705
E6983,61,89,89,80,70,389,1706
E9238,97,94,44,81,73,389,1707
E6654,84,91,72,80,62,389,1708
E6222,46,83,66,95,99,389,1709
E4181,86,59,91,66,86,388,1710
E5559,86,43,100,99,60,388,1711
E9198,44,98,81,75,90,388,1712
E4511,67,99,73,50,99,388,1713
E2111,96,41,80,80,91,388,1714
E0036,66,99,85,92,46,388,1715
E1963,81,77,79,76,75,388,1716
E5430,79,79,61,80,89,388,1717
E2254,86,82,79,51,90,388,1718
E5150,82,79,74,87,66,388,1719
E0288,87,86,77,41,97,388,1720
E9960,67,97,100,61,63,388,1721
E6351,98,92,71,58,69,388,1722
E9009,80,51,93,78,86,388,1723
E7759,55,84,100,68,81,388,1724
E5926,74,49,90,100,75,388,1725
E0897,74,50,91,88,85,388,1726
E7958,86,87,84,41,90,388,1727
E7625,69,94,69,85,71,388,1728
E9891,80,87,94,59,68,388,1729
E8283,95,92,88,45,68,388,1730
E2340,82,78,84,62,82,388,1731
E1840,94,59,99,93,43,388,1732
E4167,67,97,93,90,41,388,1733
E9497,86,65,96,82,59,388,1734
E9541,80,94,50,97,67,388,1735
E3823,87,58,98,50,95,388,1736
E4971,82,89,81,51,85,388,1737
E6224,95,68,54,72,99,388,1738
E6151,58,66,84,85,95,388,1739
E1606,84,65,87,79,73,388,1740
E3606,76,64,81,78,89,388,1741
E0572,88,90,96,50,64,388,1742
E0939,83,89,93,44,79,388,1743
E0245,95,76,76,56,85,388,1744
E0324,89,47,97,92,63,388,1745
E5179,43,94,96,68,87,388,1746
E7859,61,92,68,88,79,388,1747
E0154,63,69,78,83,95,388,1748
E8859,99,93,70,68,58,388,1749
E0657,55,84,94,82,73,388,1750
E4970,43,77,100,92,76,388,1751
E1096,88,74,64,79,83,388,1752
E4752,73,61,93,93,68,388,1753
E2753,78,100,82,51,77,388,1754
E8352,89,100,64,68,67,388,1755
E8155,82,86,73,69,78,388,1756
E0780,64,56,84,97,87,388,1757
E3032,85,84,68,87,64,388,1758
E8216,89,84,68,54,93,388,1759
E4556,59,83,73,93,80,388,1760
E5296,100,68,87,62,71,388,1761
E4072,84,90,84,56,74,388,1762
E6135,86,83,69,81,69,388,1763
E1016,67,100,97,73,51,388,1764
E6164,76,79,78,96,59,388,1765
E0568,41,58,95,95,99,388,1766
E9765,85,97,62,72,72,388,1767
E4402,67,76,68,77,100,388,1768
E7973,83,63,92,97,53,388,1769
E8542,100,80,90,49,69,388,1770
E3749,80,78,48,84,98,388,1771
E9383,70,49,99,80,90,388,1772
E4416,93,71,71,90,62,387,1773
E0183,88,100,64,72,63,387,1774
E9937,50,72,94,76,95,387,1775
E7522,75,75,86,65,86,387,1776
E5704,100,41,70,76,100,387,1777
E4759,59,94,76,88,70,387,1778
E2678,67,80,91,55,94,387,1779
E3422,63,84,77,89,74,387,1780
E3303,90,96,82,63,56,387,1781
E0818,78,90,92,63,64,387,1782
E1624,59,56,93,100,79,387,1783
E5283,66,85,81,90,65,387,1784
E0825,48,98,76,65,100,387,1785
E5983,98,53,63,88,85,387,1786
E0450,75,80,92,54,86,387,1787
E8339,65,92,87,47,96,387,1788
E8070,76,72,84,100,55,387,1789
E3942,63,74,84,96,70,387,1790
E3521,62,94,82,77,72,387,1791
E5287,53,93,96,75,70,387,1792
E3962,73,73,70,92,79,387,1793
E7153,93,72,45,96,81,387,1794
E5490,42,100,98,50,97,387,1795
E2597,50,69,72,99,97,387,1796
E9319,100,50,96,58,83,387,1797
E0161,82,70,99,50,86,387,1798
E1073,62,75,95,65,90,387,1799
E5933,100,48,71,81,87,387,1800
E5487,40,92,86,97,72,387,1801
E0175,42,66,84,97,98,387,1802
E6004,85,99,91,52,60,387,1803
E2714,96,98,83,62,48,387,1804
E1030,68,98,73,83,65,387,1805
E3916,96,52,70,93,76,387,1806
E2500,84,57,99,78,69,387,1807
E0852,98,57,87,49,96,387,1808
E3874,92,72,100,80,43,387,1809
E6895,96,88,74,63,66,387,1810
E8392,70,78,67,87,85,387,1811
E1919,99,86,90,46,66,387,1812
E3118,76,90,60,75,86,387,1813
E5829,84,76,83,57,87,387,1814
E3558,70,61,75,97,84,387,1815
E9662,43,93,63,89,99,387,1816
E8498,74,74,85,76,78,387,1817
E0524,82,78,87,46,94,387,1818
E3586,82,76,74,58,97,387,1819
E9521,77,83,50,77,100,387,1820
E7711,83,82,88,67,67,387,1821
E2614,95,88,62,90,52,387,1822
E8382,83,77,76,56,95,387,1823
E9486,60,66,87,90,84,387,1824
E8783,94,85,45,97,66,387,1825
E9744,54,93,80,68,92,387,1826
E9779,96,91,56,95,49,387,1827
E6215,41,89,79,82,96,387,1828
E4647,84,43,90,88,82,387,1829
E5843,94,80,68,66,79,387,1830
E2815,72,59,100,60,96,387,1831
E4786,85,93,51,90,68,387,1832
E8385,100,42,93,65,87,387,1833
E9573,81,71,71,74,90,387,1834
E3380,88,96,60,87,56,387,1835
E8863,49,96,76,67,99,387,1836
E1052,82,69,72,90,74,387,1837
E9284,43,87,96,66,95,387,1838
E5292,89,95,59,87,57,387,1839
E5527,96,69,46,86,90,387,1840
E6355,88,68,82,59,90,387,1841
E6730,94,83,49,94,66,386,1842
E6242,100,40,84,65,97,386,1843
E0294,73,90,100,82,41,386,1844
E1346,92,88,70,88,48,386,1845
E2645,41,94,82,96,73,386,1846
E7899,76,74,78,91,67,386,1847
E9461,65,69,76,93,83,386,1848
E1949,80,63,72,99,72,386,1849
E8200,65,97,99,69,56,386,1850
E6209,97,60,42,94,93,386,1851
E0766,85,53,67,81,100,386,1852
E5866,97,61,92,75,61,386,1853
E8014,48,89,89,69,91,386,1854
E3370,93,57,94,93,49,386,1855
E7083,100,93,41,85,67,386,1856
E8077,49,100,84,53,100,386,1857
E9218,83,87,41,98,77,386,1858
E3831,89,87,92,50,68,386,1859
E8773,44,60,94,98,90,386,1860
E4523,63,89,75,89,70,386,1861
E0753,50,83,98,64,91,386,1862
E8348,65,82,96,50,93,386,1863
E9005,88,66,66,97,69,386,1864
E2410,59,74,99,55,99,386,1865
E0420,62,83,79,66,96,386,1866
E9827,54,46,97,97,92,386,1867
E2029,77,83,94,86,46,386,1868
E5641,62,93,85,50,96,386,1869
E5489,64,93,78,96,55,386,1870
E7657,100,75,60,51,100,386,1871
E1790,42,78,79,87,100,386,1872
E4782,90,81,85,70,60,386,1873
E0006,68,86,100,81,51,386,1874
E6817,40,90,82,87,87,386,1875
E7115,63,96,64,90,73,386,1876
E6573,79,82,49,76,100,386,1877
E2341,82,77,79,100,48,386,1878
E8597,72,93,41,82,98,386,1879
E4625,43,89,56,99,99,386,1880
E9499,80,67,51,90,98,386,1881
E0714,87,68,68,95,68,386,1882
E8800,87,77,75,59,88,386,1883
E2473,95,99,58,84,50,386,1884
E2692,49,98,87,56,96,386,1885
E5581,94,90,88,41,73,386,1886
E9515,88,85,68,54,91,386,1887
E4582,52,58,89,87,100,386,1888
E4588,65,55,93,76,97,386,1889
E4240,88,94,67,62,75,386,1890
E2250,51,65,99,90,81,386,1891
E5266,74,85,50,85,92,386,1892
E1787,61,92,61,92,80,386,1893
E8931,92,43,96,73,82,386,1894
E8615,55,97,65,70,99,386,1895
E0052,80,48,87,75,96,386,1896
E7671,100,73,88,82,43,386,1897
E2373,76,91,92,62,65,386,1898
E7127,70,92,84,84,56,386,1899
E8950,55,76,77,94,84,386,1900
E4608,59,90,76,100,61,386,1901
E7636,62,95,74,60,95,386,1902
E7685,96,51,77,95,67,386,1903
E2468,83,98,67,85,53,386,1904
E5624,53,89,82,88,74,386,1905
E7354,55,57,92,82,100,386,1906
E9152,66,83,92,72,73,386,1907
E7815,53,80,62,92,98,385,1908
E7957,80,67,87,99,52,385,1909
E8596,99,71,78,67,70,385,1910
E9904,71,70,93,58,93,385,1911
E7395,73,74,96,54,88,385,1912
E2255,79,63,82,65,96,385,1913
E7402,52,96,73,96,68,385,1914
E2873,89,91,52,91,62,385,1915
E6420,76,55,92,75,87,385,1916
E6067,82,78,84,92,49,385,1917
E0451,72,84,86,79,64,385,1918
E3539,67,70,72,97,79,385,1919
E4412,94,67,45,100,79,385,1920
E9191,50,73,76,90,96,385,1921
E4750,88,41,79,88,89,385,1922
E8809,99,77,70,44,95,385,1923
E1495,100,74,85,74,52,385,1924
E5031,54,86,60,87,98,385,1925
E5578,82,86,76,85,56,385,1926
E8164,77,97,61,79,71,385,1927
E6995,84,77,80,57,87,385,1928
E6982,75,85,95,83,47,385,1929
E1622,95,84,79,71,56,385,1930
E0597,70,80,51,93,91,385,1931
E8459,78,50,96,69,92,385,1932
E7562,40,97,85,87,76,385,1933
E1902,83,66,88,83,65,385,1934
E6192,50,89,92,94,60,385,1935
E3639,62,97,60,97,69,385,1936
E4630,82,94,78,72,59,385,1937
E8383,72,40,79,98,96,385,1938
E3381,90,82,99,65,49,385,1939
E9351,93,87,68,81,56,385,1940
E0041,98,64,68,85,70,385,1941
E7666,70,61,92,79,83,385,1942
E6955,99,100,78,41,67,385,1943
E7507,89,87,41,83,85,385,1944
E1877,53,65,99,79,89,385,1945
E9391,40,65,93,94,93,385,1946
E9019,85,45,84,91,80,385,1947
E5166,62,91,72,70,90,385,1948
E3102,82,97,59,79,68,385,1949
E5906,71,91,69,54,100,385,1950
E4219,84,73,74,95,59,385,1951
E8256,90,59,91,85,60,385,1952
E1975,86,60,72,68,99,385,1953
E7270,73,45,84,97,86,385,1954
E8708,100,71,85,83,46,385,1955
E8004,78,65,88,76,78,385,1956
E3038,68,46,98,100,73,385,1957
E0829,70,41,96,97,81,385,1958
E4184,70,68,75,82,90,385,1959
E2077,94,48,76,89,78,385,1960
E7462,87,66,93,42,97,385,1961
E9975,98,98,43,50,96,385,1962
E8272,74,90,60,86,75,385,1963
E7718,74,96,74,50,91,385,1964
E1880,73,80,94,67,71,385,1965
E8990,84,64,49,89,99,385,1966
E7379,88,99,96,43,59,385,1967
E4509,65,89,92,96,43,385,1968
E5598,65,76,93,67,84,385,1969
E1850,76,87,66,73,83,385,1970
E3871,47,92,97,100,49,385,1971
E4988,98,75,46,96,70,385,1972
E1021,68,91,76,73,77,385,1973
E6491,88,50,84,76,87,385,1974
E1798,63,93,99,81,49,385,1975
E8126,82,100,59,85,59,385,1976
E0202,48,93,76,87,81,385,1977
E1848,67,66,98,56,98,385,1978
E6082,64,96,93,58,74,385,1979
E1161,62,99,55,85,84,385,1980
E2533,67,57,80,93,88,385,1981
E5710,64,94,85,59,82,384,1982
E2069,80,54,97,84,69,384,1983
E9523,77,77,90,80,60,384,1984
E9099,97,84,54,68,81,384,1985
E5071,93,66,77,50,98,384,1986
E0558,81,71,66,83,83,384,1987
E2126,53,71,99,90,71,384,1988
E4064,51,45,99,90,99,384,1989
E2263,82,97,83,70,52,384,1990
E4060,96,64,85,54,85,384,1991
E4612,76,82,61,70,95,384,1992
E4009,97,65,81,45,96,384,1993
E5706,87,62,79,87,69,384,1994
E7825,75,100,91,61,57,384,1995
E3238,45,89,94,58,98,384,1996
E9125,48,90,75,92,79,384,1997
E2999,81,86,81,55,81,384,1998
E0985,92,78,62,96,56,384,1999
E2480,44,85,68,97,90,384,2000
E9506,75,45,72,98,94,384,2001
E2302,41,91,76,86,90,384,2002
E0700,95,65,49,96,79,384,2003
E3172,56,72,86,94,76,384,2004
E4721,73,77,99,73,62,384,2005
E3337,89,75,53,90,77,384,2006
E9215,93,40,95,66,90,384,2007
E6554,51,88,81,68,96,384,2008
E8694,84,58,73,81,88,384,2009
E8552,53,82,57,94,98,384,2010
E4309,98,50,85,55,96,384,2011
E8262,61,83,92,48,100,384,2012
E8616,74,85,80,68,77,384,2013
E3257,60,93,40,100,91,384,2014
E1221,69,95,96,79,45,384,2015
E5422,95,60,52,79,98,384,2016
E1839,95,75,71,44,99,384,2017
E7499,46,100,77,90,71,384,2018
E1003,73,73,74,84,80,384,2019
E6158,60,58,91,79,96,384,2020
E4273,67,93,59,93,72,384,2021
E4666,97,74,62,67,84,384,2022
E4774,78,61,85,72,88,384,2023
E5180,69,62,82,93,78,384,2024
E4241,86,74,94,62,68,384,2025
E2436,80,97,68,84,55,384,2026
E1245,73,99,60,68,84,384,2027
E0876,44,88,95,88,69,384,2028
E5395,79,60,98,84,63,384,2029
E5365,90,77,59,67,91,384,2030
E3078,89,46,82,83,84,384,2031
E0819,81,85,84,79,55,384,2032
E7836,96,81,82,65,60,384,2033
E3861,98,82,68,84,52,384,2034
E6549,56,85,91,82,70,384,2035
E9843,51,91,94,57,91,384,2036
E1037,90,98,92,50,54,384,2037
E9717,94,69,83,59,79,384,2038
E8748,91,75,75,100,43,384,2039
E9494,83,53,74,83,91,384,2040
E5219,81,70,92,51,90,384,2041
E1633,84,72,54,82,92,384,2042
E8895,42,68,81,95,98,384,2043
E1649,65,91,52,89,87,384,2044
E7023,79,95,82,69,59,384,2045
E4341,73,99,71,46,94,383,2046
E5995,56,48,93,95,91,383,2047
E7550,65,98,66,81,73,383,2048
E3015,68,82,79,57,97,383,2049
E0699,99,45,55,95,89,383,2050
E6205,89,100,50,62,82,383,2051
E5206,90,59,86,91,57,383,2052
E9584,92,47,92,77,75,383,2053
E4448,87,93,48,87,68,383,2054
E2641,64,75,94,99,51,383,2055
E4731,89,69,62,64,99,383,2056
E9869,80,48,99,67,89,383,2057
E8294,73,94,64,91,61,383,2058
E0828,93,68,75,86,61,383,2059
E0679,61,91,92,46,93,383,2060
E5037,93,90,68,42,90,383,2061
E3085,81,100,96,57,49,383,2062
E6427,84,58,96,57,88,383,2063
E9030,89,86,73,83,52,383,2064
E2389,50,96,87,80,70,383,2065
E2713,75,60,58,92,98,383,2066
E6941,85,90,62,89,57,383,2067
E8767,68,81,72,66,96,383,2068
E4465,46,84,100,92,61,383,2069
E7099,87,63,89,48,96,383,2070
E5449,92,90,43,88,70,383,2071
E9314,69,56,84,85,89,383,2072
E7588,73,61,100,62,87,383,2073
E1660,44,73,99,89,78,383,2074
E4495,84,83,88,70,58,383,2075
E6736,85,91,58,51,98,383,2076
E1023,89,70,98,66,60,383,2077
E2035,88,55,82,74,84,383,2078
E2101,77,64,96,46,100,383,2079
E2909,100,68,61,98,56,383,2080
E6679,69,94,46,89,85,383,2081
E9496,69,99,61,85,69,383,2082
E2777,43,68,91,86,95,383,2083
E0454,87,41,75,93,87,383,2084
E9564,89,54,97,48,95,383,2085
E0169,70,81,94,66,72,383,2086
E2859,76,94,58,55,100,383,2087
E7155,54,96,41,99,93,383,2088
E1857,83,51,91,79,79,383,2089
E6493,97,62,69,89,66,383,2090
E7659,75,78,43,93,94,383,2091
E8251,79,91,83,49,81,383,2092
E1895,92,93,85,45,68,383,2093
E6037,65,62,86,91,79,383,2094
E5385,65,82,98,50,88,383,2095
E2853,85,57,78,68,95,383,2096
E3461,66,91,80,69,77,383,2097
E8761,98,51,90,46,98,383,2098
E4031,81,53,73,83,93,383,2099
E5813,90,85,77,79,52,383,2100
E9269,90,86,52,65,90,383,2101
E0666,44,93,73,74,99,383,2102
E4572,55,95,99,82,52,383,2103
E5814,99,45,63,94,82,383,2104
E5772,72,91,67,90,63,383,2105
E5616,56,95,64,75,93,383,2106
E3442,42,99,71,88,83,383,2107
E2623,82,88,49,69,95,383,2108
E8919,51,82,62,97,91,383,2109
E2663,46,73,89,90,85,383,2110
E0399,100,84,69,47,83,383,2111
E6178,52,85,80,83,83,383,2112
E0823,71,85,88,77,62,383,2113
E9868,47,96,67,99,74,383,2114
E0258,92,97,56,94,44,383,2115
E7077,55,83,99,72,74,383,2116
E3183,96,81,100,60,46,383,2117
E4265,94,89,56,72,72,383,2118
E0298,56,88,81,89,69,383,2119
E9742,58,77,90,60,98,383,2120
E6954,100,88,61,91,43,383,2121
E6793,77,44,84,95,83,383,2122
E0740,92,97,55,51,87,382,2123
E3615,89,89,96,41,67,382,2124
E6835,73,63,80,73,93,382,2125
E5198,63,86,79,61,93,382,2126
E5508,95,89,50,81,67,382,2127
E7467,99,62,90,52,79,382,2128
E8275,96,71,45,86,84,382,2129
E4732,78,84,70,94,56,382,2130
E0378,54,88,98,53,89,382,2131
E8396,85,88,55,85,69,382,2132
E5501,67,83,65,76,91,382,2133
E2754,66,99,69,51,97,382,2134
E4818,100,71,49,70,92,382,2135
E5185,70,62,93,91,66,382,2136
E1541,88,100,87,56,51,382,2137
E6510,67,62,92,92,69,382,2138
E9948,92,47,76,68,99,382,2139
E5469,93,63,50,85,91,382,2140
E8649,85,81,79,64,73,382,2141
E6783,78,70,78,100,56,382,2142
E1422,80,99,66,66,71,382,2143
E3905,74,99,87,68,54,382,2144
E7870,48,99,69,68,98,382,2145
E4704,90,87,48,98,59,382,2146
E7049,100,94,66,65,57,382,2147
E6907,63,58,98,82,81,382,2148
E7365,96,74,53,70,89,382,2149
E9489,79,66,62,91,84,382,2150
E7906,71,98,76,75,62,382,2151
E6231,62,63,88,90,79,382,2152
E7198,87,97,47,71,80,382,2153
E0967,85,56,83,81,77,382,2154
E2474,56,75,71,89,91,382,2155
E0248,48,96,69,75,94,382,2156
E4703,59,78,59,95,91,382,2157
E0374,100,86,88,60,48,382,2158
E5784,94,85,79,59,65,382,2159
E9051,85,92,77,42,86,382,2160
E7885,85,77,83,74,63,382,2161
E0916,68,78,65,97,74,382,2162
E3144,74,73,91,77,67,382,2163
E1154,49,100,65,96,72,382,2164
E4435,57,63,87,88,87,382,2165
E8577,97,55,71,61,98,382,2166
E4213,64,66,80,79,93,382,2167
E2561,70,84,78,81,69,382,2168
E5299,51,94,79,75,83,382,2169
E5666,100,76,44,92,70,382,2170
E3501,95,79,75,48,85,382,2171
E9602,89,60,72,66,95,382,2172
E5183,72,88,99,80,43,382,2173
E2724,77,72,95,40,98,382,2174
E5392,57,91,98,71,65,382,2175
E8185,72,72,92,89,57,382,2176
E4423,87,48,96,92,59,382,2177
E9452,75,67,100,88,52,382,2178
E6230,84,81,74,79,64,382,2179
E8514,40,97,93,97,55,382,2180
E3598,96,93,51,100,42,382,2181
E4815,63,63,87,89,80,382,2182
E8378,93,40,88,100,61,382,2183
E5807,79,95,73,40,95,382,2184
E9999,92,42,85,82,81,382,2185
E9393,58,85,53,88,98,382,2186
E9650,76,58,89,68,91,382,2187
E1350,84,56,65,90,87,382,2188
E7910,75,87,47,78,95,382,2189
E2664,99,53,96,74,60,382,2190
E3947,40,70,93,98,81,382,2191
E2925,97,98,78,63,46,382,2192
E9065,91,46,91,60,93,381,2193
E7721,100,97,88,46,50,381,2194
E7933,88,97,55,70,71,381,2195
E4855,52,99,97,90,43,381,2196
E4804,99,73,80,84,45,381,2197
E6537,94,97,64,74,52,381,2198
E3976,70,91,86,41,93,381,2199
E1146,78,55,64,93,91,381,2200
E5463,70,83,80,93,55,381,2201
E1563,58,77,72,94,80,381,2202
E2996,53,63,96,79,90,381,2203
E0320,94,88,86,59,54,381,2204
E4915,82,80,97,57,65,381,2205
E0525,94,44,91,71,81,381,2206
E9518,98,60,58,67,98,381,2207
E5070,74,44,88,87,88,381,2208
E3545,76,73,93,90,49,381,2209
E2355,87,62,58,94,80,381,2210
E8578,63,66,67,93,92,381,2211
E3034,62,56,81,95,87,381,2212
E3884,83,91,80,56,71,381,2213
E6022,79,79,64,83,76,381,2214
E6542,76,61,82,65,97,381,2215
E7165,75,95,93,48,70,381,2216
E4227,72,78,51,86,94,381,2217
E1507,91,58,55,91,86,381,2218
E6257,77,90,62,52,100,381,2219
E3714,59,93,93,96,40,381,2220
E6705,68,72,65,84,92,381,2221
E7106,42,92,59,96,92,381,2222
E4261,91,80,61,64,85,381,2223
E7321,97,44,89,93,58,381,2224
E9166,95,85,67,44,90,381,2225
E3808,98,42,72,71,98,381,2226
E4316,53,98,98,59,73,381,2227
E5417,85,45,95,79,77,381,2228
E7362,65,50,94,87,85,381,2229
E0186,46,83,97,90,65,381,2230
E3658,98,54,83,52,94,381,2231
E7264,72,72,91,48,98,381,2232
E4994,96,43,89,94,59,381,2233
E0859,87,95,57,51,91,381,2234
E5371,92,74,90,68,57,381,2235
E5328,63,85,81,53,99,381,2236
E5584,81,65,91,48,96,381,2237
E8463,93,71,94,61,62,381,2238
E2142,83,85,95,42,76,381,2239
E2699,85,57,70,90,79,381,2240
E2092,95,48,65,98,75,381,2241
E4367,86,44,99,62,90,381,2242
E8328,65,84,89,80,63,381,2243
E6129,87,61,96,50,87,381,2244
E5359,66,78,98,95,44,381,2245
E6748,58,80,61,92,90,381,2246
E8888,86,86,58,99,52,381,2247
E4369,98,63,53,70,97,381,2248
E5222,79,59,80,70,93,381,2249
E9730,95,87,73,48,78,381,2250
E4434,81,98,95,59,48,381,2251
E4564,80,82,94,52,73,381,2252
E6832,93,96,71,51,70,381,2253
E7975,66,89,69,98,59,381,2254
E1860,55,91,63,88,84,381,2255
E6515,80,76,100,46,79,381,2256
E0285,95,95,76,60,55,381,2257
E8096,88,89,66,70,68,381,2258
E8786,84,61,61,92,83,381,2259
E6909,66,71,88,67,89,381,2260
E1494,82,81,95,70,53,381,2261
E6244,98,68,79,62,74,381,2262
E6610,89,61,88,53,90,381,2263
E2134,62,100,89,65,65,381,2264
E9855,79,85,76,54,87,381,2265
E6318,78,87,99,57,60,381,2266
E0759,69,68,98,48,98,381,2267
E1403,57,74,94,99,57,381,2268
E5655,61,76,97,100,47,381,2269
E7662,40,98,70,96,77,381,2270
E0756,46,96,99,49,91,381,2271
E5136,52,87,73,94,75,381,2272
E7417,65,99,81,44,92,381,2273
E8269,42,73,79,89,98,381,2274
E0405,45,89,94,69,84,381,2275
E9823,85,69,74,69,84,381,2276
E8549,70,88,78,47,97,380,2277
E3063,87,77,43,88,85,380,2278
E5036,81,59,75,91,74,380,2279
E9754,42,99,87,68,84,380,2280
E4314,75,90,78,89,48,380,2281
E7849,48,91,67,88,86,380,2282
E8368,48,99,94,43,96,380,2283
E6388,50,81,70,94,85,380,2284
E0182,80,51,91,90,68,380,2285
E6498,96,90,40,76,78,380,2286
E4832,50,94,99,55,82,380,2287
E0403,46,76,60,98,100,380,2288
E5905,99,44,83,86,68,380,2289
E2835,59,55,92,79,95,380,2290
E4229,73,56,75,91,85,380,2291
E2262,67,91,95,62,65,380,2292
E0100,86,73,43,78,100,380,2293
E0861,91,68,49,89,83,380,2294
E7808,93,72,94,78,43,380,2295
E2113,52,96,74,67,91,380,2296
E6314,81,87,52,78,82,380,2297
E4137,82,60,88,52,98,380,2298
E7225,76,72,90,90,52,380,2299
E3105,62,86,82,85,65,380,2300
E1166,68,91,49,91,81,380,2301
E0978,79,85,79,89,48,380,2302
E2828,72,87,79,44,98,380,2303
E3802,87,70,97,86,40,380,2304
E3178,99,89,66,67,59,380,2305
E6111,92,95,64,56,73,380,2306
E9925,95,63,65,58,99,380,2307
E6144,75,72,93,95,45,380,2308
E0721,58,79,100,87,56,380,2309
E6622,68,57,64,93,98,380,2310
E6384,64,76,83,77,80,380,2311
E2854,92,90,51,64,83,380,2312
E1766,93,61,84,82,60,380,2313
E2861,66,89,90,92,43,380,2314
E9352,77,73,63,91,76,380,2315
E1777,49,88,88,60,95,380,2316
E8538,67,99,65,67,82,380,2317
E6091,47,93,80,73,87,380,2318
E7942,71,92,77,58,82,380,2319
E4026,70,75,97,76,62,380,2320
E3342,80,53,90,72,85,380,2321
E7578,79,89,66,65,81,380,2322
E8683,57,75,97,59,92,380,2323
E8020,91,83,60,47,99,380,2324
E4342,69,78,56,100,77,380,2325
E6867,71,59,94,95,61,380,2326
E8856,51,99,58,86,86,380,2327
E5168,84,87,64,87,58,380,2328
E9362,71,86,77,77,69,380,2329
E8869,73,86,88,89,44,380,2330
E2918,92,59,62,94,73,380,2331
E4544,43,89,68,88,92,380,2332
E3700,87,46,80,91,76,380,2333
E5020,94,99,53,79,55,380,2334
E0601,46,81,60,98,95,380,2335
E2924,84,64,61,93,78,380,2336
E6541,60,98,99,46,77,380,2337
E1511,51,61,99,82,87,380,2338
E6165,92,81,57,95,55,380,2339
E2748,76,60,88,95,61,380,2340
E1736,96,40,99,63,82,380,2341
E7454,99,64,77,79,61,380,2342
E6516,80,97,54,82,66,379,2343
E3998,63,44,96,92,84,379,2344
E6643,93,70,55,89,72,379,2345
E7475,76,86,58,96,63,379,2346
E3437,69,85,94,88,43,379,2347
E9838,74,88,55,74,88,379,2348
E7797,94,63,94,61,67,379,2349
E9803,66,54,76,97,86,379,2350
E5482,89,92,43,90,65,379,2351
E3564,94,46,56,94,89,379,2352
E2686,60,96,55,90,78,379,2353
E9435,62,73,97,59,88,379,2354
E8926,88,58,84,59,90,379,2355
E5502,44,97,73,93,72,379,2356
E4677,91,56,59,80,93,379,2357
E9256,87,71,90,70,61,379,2358
E6485,94,40,73,75,97,379,2359
E3351,89,86,76,43,85,379,2360
E4016,69,75,92,75,68,379,2361
E3540,83,93,57,51,95,379,2362
E4884,83,73,44,80,99,379,2363
E3911,99,86,51,46,97,379,2364
E2781,100,97,50,89,43,379,2365
E1256,92,56,84,81,66,379,2366
E6221,45,81,81,76,96,379,2367
E1130,67,66,66,100,80,379,2368
E2266,95,67,62,86,69,379,2369
E3949,75,77,92,75,60,379,2370
E6262,92,68,59,65,95,379,2371
E9582,82,95,72,42,88,379,2372
E2822,91,77,78,83,50,379,2373
E1169,45,98,85,51,100,379,2374
E6964,62,63,89,98,67,379,2375
E2739,56,63,64,96,100,379,2376
E8745,98,60,85,52,84,379,2377
E3012,94,67,96,76,46,379,2378
E9041,72,47,84,88,88,379,2379
E2889,53,85,95,87,59,379,2380
E3414,59,75,83,83,79,379,2381
E1960,63,73,65,89,89,379,2382
E8042,88,100,94,54,43,379,2383
E2747,97,66,100,70,46,379,2384
E4178,82,94,78,63,62,379,2385
E7809,92,96,73,57,61,379,2386
E0521,80,88,75,83,53,379,2387
E7520,92,84,52,68,83,379,2388
E4561,67,97,69,87,59,379,2389
E8434,46,78,69,90,96,379,2390
E4110,77,82,72,93,55,379,2391
E0796,89,42,80,83,85,379,2392
E6952,100,90,43,85,61,379,2393
E9596,44,70,93,92,80,379,2394
E5017,65,98,43,95,78,379,2395
E4577,53,81,91,95,59,379,2396
E6425,95,96,52,64,72,379,2397
E5875,64,67,58,95,95,379,2398
E5811,90,53,81,84,71,379,2399
E5834,92,65,83,91,48,379,2400
E7054,63,99,90,52,75,379,2401
E4516,99,71,74,62,73,379,2402
E7618,92,50,58,86,93,379,2403
E7249,50,77,99,95,58,379,2404
E4716,65,70,83,83,78,379,2405
E7024,68,60,83,73,95,379,2406
E4255,86,87,78,41,87,379,2407
E9245,76,89,46,83,85,379,2408
E5114,89,51,75,94,70,379,2409
E7844,86,93,96,48,56,379,2410
E9434,99,58,90,45,87,379,2411
E9557,89,92,68,50,80,379,2412
E5652,49,67,90,79,94,379,2413
E3944,59,93,44,95,88,379,2414
E2559,92,90,41,59,97,379,2415
E1669,92,82,44,94,67,379,2416
E1873,54,96,65,72,92,379,2417
E6742,100,87,71,43,78,379,2418
E2388,89,53,65,74,98,379,2419
E8099,87,90,85,63,54,379,2420
E9987,72,65,99,93,50,379,2421
E0771,97,71,54,92,65,379,2422
E7281,71,85,46,86,91,379,2423
E1048,81,90,81,64,63,379,2424
E6317,65,90,86,66,72,379,2425
E9110,85,50,88,56,100,379,2426
E3559,48,96,77,99,59,379,2427
E0920,71,83,43,98,84,379,2428
E4745,93,82,67,90,47,379,2429
E8444,90,56,57,89,87,379,2430
E1077,98,84,55,57,85,379,2431
E4323,70,86,77,84,62,379,2432
E2023,77,100,74,48,80,379,2433
E9644,99,77,88,59,56,379,2434
E0712,54,70,77,84,94,379,2435
E7810,82,43,79,77,97,378,2436
E0508,90,41,91,89,67,378,2437
E9689,84,74,78,99,43,378,2438
E3296,53,86,78,88,73,378,2439
E6836,83,96,50,64,85,378,2440
E3292,78,57,63,99,81,378,2441
E6682,100,62,83,61,72,378,2442
E6486,77,91,92,48,70,378,2443
E3830,86,95,45,76,76,378,2444
E0366,67,68,97,94,52,378,2445
E6126,49,91,91,83,64,378,2446
E1527,52,94,58,97,77,378,2447
E1594,56,40,100,95,87,378,2448
E3227,76,87,56,69,90,378,2449
E4581,60,96,70,90,62,378,2450
E7336,66,74,96,94,48,378,2451
E8244,74,94,91,48,71,378,2452
E0574,64,70,48,99,97,378,2453
E2605,68,71,76,88,75,378,2454
E9930,82,72,55,73,96,378,2455
E5204,85,96,57,86,54,378,2456
E2866,81,95,47,60,95,378,2457
E0411,51,91,67,70,99,378,2458
E3690,46,87,83,92,70,378,2459
E5885,66,52,98,73,89,378,2460
E6431,78,90,98,51,61,378,2461
E3192,83,47,86,94,68,378,2462
E0333,43,98,92,80,65,378,2463
E6674,59,57,96,75,91,378,2464
E7532,88,98,59,65,68,378,2465
E4722,89,55,61,73,100,378,2466
E0389,84,62,90,90,52,378,2467
E3507,77,76,82,59,84,378,2468
E1623,97,92,44,51,94,378,2469
E4872,91,66,59,98,64,378,2470
E1826,82,99,91,62,44,378,2471
E3195,99,49,92,75,63,378,2472
E7504,89,62,98,70,59,378,2473
E3602,77,60,64,90,87,378,2474
E5861,93,63,57,100,65,378,2475
E4811,96,57,62,77,86,378,2476
E7804,74,49,92,69,94,378,2477
E1888,42,74,78,100,84,378,2478
E5153,74,67,94,73,70,378,2479
E9425,71,72,79,93,63,378,2480
E0143,73,61,93,81,70,378,2481
E5361,60,94,61,71,92,378,2482
E1036,58,92,88,59,81,378,2483
E0940,69,48,82,87,92,378,2484
E2387,91,75,77,83,52,378,2485
E2571,94,81,46,84,73,378,2486
E0102,79,91,47,86,75,378,2487
E3601,86,66,73,94,59,378,2488
E5770,96,74,96,53,59,378,2489
E4999,65,52,71,100,90,378,2490
E0131,80,99,80,47,72,378,2491
E2141,66,94,85,72,61,378,2492
E3114,92,79,47,71,89,378,2493
E6838,49,100,58,81,90,378,2494
E7513,84,100,45,86,63,378,2495
E8711,87,79,52,64,96,378,2496
E0895,100,66,70,59,83,378,2497
E6196,95,75,55,60,93,378,2498
E8189,58,78,76,88,78,378,2499
E7613,65,58,92,80,83,378,2500
E8408,91,90,56,43,98,378,2501
E8315,77,80,93,61,67,378,2502
E2145,67,75,41,100,95,378,2503
E5642,56,45,91,98,88,378,2504
E0190,43,90,57,91,97,378,2505
E5309,98,56,65,72,87,378,2506
E0864,87,76,78,89,48,378,2507
E0240,40,83,98,78,79,378,2508
E1310,76,61,91,98,52,378,2509
E7351,87,88,52,56,95,378,2510
E5134,99,60,69,85,65,378,2511
E8758,67,66,94,56,95,378,2512
E2118,89,88,76,66,59,378,2513
E1209,97,40,89,81,71,378,2514
E7847,54,61,88,79,96,378,2515
E9389,56,94,56,94,77,377,2516
E6668,99,68,76,89,45,377,2517
E0359,100,69,83,74,51,377,2518
E9928,77,99,58,66,77,377,2519
E2045,70,92,70,73,72,377,2520
E3516,60,74,71,91,81,377,2521
E9488,90,84,50,64,89,377,2522
E6272,60,49,87,92,89,377,2523
E8959,57,70,99,75,76,377,2524
E4015,92,62,80,44,99,377,2525
E4306,80,48,90,59,100,377,2526
E7658,76,43,88,90,80,377,2527
E0800,48,93,80,82,74,377,2528
E2504,69,40,85,97,86,377,2529
E2940,91,56,68,96,66,377,2530
E1493,89,45,95,68,80,377,2531
E1885,95,48,95,85,54,377,2532
E7633,94,92,72,43,76,377,2533
E9201,65,69,100,97,46,377,2534
E3500,58,84,65,95,75,377,2535
E7629,89,83,58,69,78,377,2536
E5686,99,63,56,93,66,377,2537
E5433,68,98,99,54,58,377,2538
E5255,41,60,92,97,87,377,2539
E9900,69,47,93,79,89,377,2540
E8845,82,85,65,53,92,377,2541
E3082,93,66,40,89,89,377,2542
E3025,92,63,62,62,98,377,2543
E2930,97,94,72,55,59,377,2544
E1360,76,59,87,69,86,377,2545
E0711,83,93,63,44,94,377,2546
E6967,91,44,92,87,63,377,2547
E6860,90,52,72,92,71,377,2548
E7512,74,58,69,88,88,377,2549
E2771,46,89,68,81,93,377,2550
E4616,50,75,78,99,75,377,2551
E2635,61,85,66,68,97,377,2552
E2530,98,64,50,81,84,377,2553
E9373,76,88,49,66,98,377,2554
E9699,61,82,61,91,82,377,2555
E1821,90,91,50,64,82,377,2556
E5969,84,69,87,67,70,377,2557
E1724,97,79,79,63,59,377,2558
E7455,92,56,87,100,42,377,2559
E2048,73,67,100,70,67,377,2560
E5590,81,48,94,54,100,377,2561
E2600,99,45,83,64,86,377,2562
E1838,67,56,83,99,72,377,2563
E8826,72,56,71,90,88,377,2564
E1618,43,86,72,88,88,377,2565
E3004,100,40,97,58,82,377,2566
E5893,70,52,87,74,94,377,2567
E4270,96,49,96,63,73,377,2568
E8053,75,100,55,91,56,377,2569
E0396,43,80,85,71,98,377,2570
E2491,82,80,93,79,43,377,2571
E9277,96,91,40,67,83,377,2572
E7383,66,87,85,48,91,377,2573
E7713,95,100,42,51,89,377,2574
E4730,95,85,47,55,95,377,2575
E6711,52,57,91,87,90,377,2576
E7827,90,88,93,44,62,377,2577
E0237,42,84,63,97,91,377,2578
E2394,73,83,86,43,92,377,2579
E6479,84,77,64,90,62,377,2580
E5943,78,54,88,92,65,377,2581
E8988,91,81,57,78,70,377,2582
E8743,83,82,44,76,92,377,2583
E9402,85,91,59,54,88,377,2584
E3835,76,81,71,77,72,377,2585
E4098,60,87,82,57,91,377,2586
E8206,62,97,48,88,82,377,2587
E2762,61,56,71,97,92,377,2588
E7569,59,64,92,83,79,377,2589
E4061,90,70,89,70,58,377,2590
E5423,56,99,96,66,60,377,2591
E8440,98,93,69,74,43,377,2592
E2981,56,99,88,84,50,377,2593
E8360,85,69,87,51,85,377,2594
E5845,71,97,100,42,67,377,2595
E3895,61,90,65,90,71,377,2596
E5964,71,65,76,87,78,377,2597
E3524,98,83,63,92,41,377,2598
E5187,74,94,42,82,85,377,2599
E2136,74,82,42,88,90,376,2600
E7644,77,53,98,88,60,376,2601
E3310,71,93,79,89,44,376,2602
E1758,67,47,98,75,89,376,2603
E2385,67,76,56,89,88,376,2604
E2990,76,53,96,96,55,376,2605
E8935,57,82,81,68,88,376,2606
E7784,53,75,88,63,97,376,2607
E4902,95,88,71,73,49,376,2608
E4963,54,98,70,78,76,376,2609
E7048,54,93,87,54,88,376,2610
E6087,100,83,58,47,88,376,2611
E7608,78,53,81,89,75,376,2612
E7974,78,61,58,85,94,376,2613
E2966,99,56,63,89,69,376,2614
E0482,63,84,93,55,81,376,2615
E8238,84,48,61,91,92,376,2616
E7623,45,95,63,75,98,376,2617
E1747,97,67,80,59,73,376,2618
E0585,61,85,56,78,96,376,2619
E4142,68,83,87,42,96,376,2620
E1082,76,74,93,72,61,376,2621
E3904,58,48,80,95,95,376,2622
E9183,51,82,88,59,96,376,2623
E3632,70,83,71,61,91,376,2624
E4458,52,55,94,80,95,376,2625
E0066,83,50,76,78,89,376,2626
E8065,76,90,79,76,55,376,2627
E2869,61,100,90,45,80,376,2628
E9460,88,98,60,62,68,376,2629
E7011,87,49,91,97,52,376,2630
E4294,87,76,58,65,90,376,2631
E6333,45,81,93,97,60,376,2632
E9863,57,96,84,73,66,376,2633
E1005,87,79,80,64,66,376,2634
E2675,92,95,82,44,63,376,2635
E8886,97,99,61,67,52,376,2636
E1372,50,67,90,98,71,376,2637
E9777,97,57,58,99,65,376,2638
E7839,40,79,99,66,92,376,2639
E5714,80,92,51,100,53,376,2640
E9907,93,53,60,95,75,376,2641
E7190,60,84,68,97,67,376,2642
E6374,54,100,65,79,78,376,2643
E5012,87,89,75,82,43,376,2644
E1473,79,40,65,95,97,376,2645
E8897,96,47,58,100,75,376,2646
E5068,74,71,78,80,73,376,2647
E4890,84,90,42,65,95,376,2648
E6759,93,40,87,84,72,376,2649
E0842,44,69,100,89,74,376,2650
E3735,96,89,75,58,58,376,2651
E2793,90,96,58,67,65,376,2652
E7610,59,81,92,93,51,376,2653
E8047,91,77,59,100,49,376,2654
E5961,73,73,93,81,56,376,2655
E9477,68,100,70,86,52,376,2656
E2611,46,87,91,79,73,376,2657
E2443,69,84,47,93,83,376,2658
E1808,82,74,58,84,78,376,2659
E6194,54,81,94,76,71,376,2660
E8131,40,76,88,90,82,376,2661
E4578,57,100,95,75,49,376,2662
E1801,60,91,60,98,67,376,2663
E4682,62,93,61,62,98,376,2664
E8772,94,69,85,75,53,376,2665
E5561,97,43,87,72,77,376,2666
E5158,89,92,76,53,66,376,2667
E8984,89,97,50,58,82,376,2668
E4689,88,55,73,82,78,376,2669
E1537,84,83,64,67,78,376,2670
E9921,76,71,68,79,82,376,2671
E5099,52,79,68,78,99,376,2672
E5785,96,73,67,79,61,376,2673
E5657,98,65,96,45,72,376,2674
E9934,94,76,50,58,98,376,2675
E0848,95,97,60,84,40,376,2676
E5143,44,68,82,85,97,376,2677
E4575,73,93,67,73,70,376,2678
E0540,87,47,98,49,95,376,2679
E4474,66,88,79,56,87,376,2680
E4260,93,75,54,71,83,376,2681
E2110,82,81,75,58,80,376,2682
E1263,48,92,72,100,64,376,2683
E7584,70,91,79,59,77,376,2684
E0554,70,43,77,100,86,376,2685
E0503,80,74,74,49,99,376,2686
E8118,88,99,72,75,42,376,2687
E0778,87,83,71,71,64,376,2688
E9148,79,97,89,69,42,376,2689
E7075,81,76,73,88,58,376,2690
E4693,76,47,98,61,94,376,2691
E5432,77,97,61,42,99,376,2692
E0810,49,95,81,93,58,376,2693
E5879,98,86,79,58,55,376,2694
E8715,80,47,100,77,72,376,2695
E7310,91,60,92,78,55,376,2696
E1204,58,73,100,64,80,375,2697
E4001,91,49,81,61,93,375,2698
E0560,94,71,80,45,85,375,2699
E6885,92,73,67,96,47,375,2700
E5856,54,53,81,88,99,375,2701
E5664,85,92,87,57,54,375,2702
E5344,84,79,60,63,89,375,2703
E5171,71,63,84,85,72,375,2704
E1343,97,76,42,82,78,375,2705
E9285,72,72,90,81,60,375,2706
E8797,81,65,51,97,81,375,2707
E8661,96,60,71,77,71,375,2708
E2393,75,83,71,85,61,375,2709
E1827,77,87,49,69,93,375,2710
E8217,95,72,75,45,88,375,2711
E1709,97,91,83,48,56,375,2712
E6252,77,69,85,61,83,375,2713
E1475,42,77,78,80,98,375,2714
E5586,87,43,83,78,84,375,2715
E2176,55,80,77,95,68,375,2716
E7104,59,53,68,98,97,375,2717
E6819,96,57,71,95,56,375,2718
E1611,73,83,76,43,100,375,2719
E2021,52,81,77,74,91,375,2720
E3592,67,92,68,84,64,375,2721
E5513,67,49,90,76,93,375,2722
E0217,77,65,100,79,54,375,2723
E5372,89,60,100,82,44,375,2724
E8509,58,47,88,94,88,375,2725
E4409,99,52,65,98,61,375,2726
E1961,69,67,62,80,97,375,2727
E4801,68,83,88,48,88,375,2728
E4776,65,91,86,61,72,375,2729
E6098,57,74,98,54,92,375,2730
E3138,72,98,46,92,67,375,2731
E2922,77,61,88,88,61,375,2732
E2147,60,77,61,80,97,375,2733
E0911,95,92,70,53,65,375,2734
E3537,71,82,84,45,93,375,2735
E8729,69,88,84,76,58,375,2736
E6718,91,94,59,77,54,375,2737
E4191,79,70,59,86,81,375,2738
E2532,73,83,75,88,56,375,2739
E7922,90,71,73,60,81,375,2740
E7868,87,58,91,76,63,375,2741
E8059,72,58,53,95,97,375,2742
E5444,99,43,91,77,65,375,2743
E3042,63,68,95,55,94,375,2744
E8159,44,86,96,77,72,375,2745
E9246,74,93,45,87,76,375,2746
E7756,94,74,77,47,83,375,2747
E5442,66,79,42,96,92,375,2748
E8127,41,84,88,68,94,375,2749
E4130,66,89,44,94,82,375,2750
E3360,86,53,94,100,42,375,2751
E3940,98,77,64,70,66,375,2752
E2992,86,66,62,83,78,375,2753
E0654,79,79,52,88,77,375,2754
E1533,83,78,77,47,90,375,2755
E1504,89,53,61,93,79,375,2756
E4697,58,85,82,70,80,375,2757
E7273,99,87,46,69,74,375,2758
E9227,40,90,86,89,70,375,2759
E2155,65,91,74,82,63,375,2760
E7305,44,98,96,86,51,375,2761
E2440,47,69,83,93,83,375,2762
E5061,81,68,75,78,73,375,2763
E9395,63,78,81,72,81,375,2764
E0462,98,74,96,59,48,375,2765
E0982,81,91,62,67,74,375,2766
E2007,86,66,50,80,93,375,2767
E3723,88,68,83,47,89,375,2768
E5612,94,58,49,84,90,375,2769
E1501,90,63,100,77,44,374,2770
E0566,88,60,90,42,94,374,2771
E3410,83,99,71,71,50,374,2772
E3517,95,81,75,67,56,374,2773
E7979,64,97,75,51,87,374,2774
E8474,95,73,46,97,63,374,2775
E0108,92,93,62,83,44,374,2776
E7669,47,75,81,73,98,374,2777
E3247,68,97,45,94,70,374,2778
E6741,75,62,87,50,100,374,2779
E7098,80,67,62,82,83,374,2780
E4734,62,65,82,90,75,374,2781
E6615,68,59,75,84,88,374,2782
E2729,77,83,73,62,79,374,2783
E7769,95,44,57,86,92,374,2784
E3531,40,90,88,63,93,374,2785
E7324,44,75,91,81,83,374,2786
E6106,88,73,80,42,91,374,2787
E0212,42,91,95,86,60,374,2788
E3967,53,72,100,86,63,374,2789
E2833,92,52,76,66,88,374,2790
E6173,87,89,85,42,71,374,2791
E6904,85,51,90,87,61,374,2792
E8947,55,81,83,94,61,374,2793
E5654,56,89,64,96,69,374,2794
E0003,93,59,65,83,74,374,2795
E4147,72,82,86,84,50,374,2796
E0260,96,47,87,80,64,374,2797
E3650,77,88,67,63,79,374,2798
E9529,86,65,65,99,59,374,2799
E1108,57,100,67,72,78,374,2800
E9200,74,64,98,86,52,374,2801
E0009,44,69,85,95,81,374,2802
E1234,72,40,70,95,97,374,2803
E0472,73,80,58,71,92,374,2804
E3417,89,68,67,93,57,374,2805
E0995,72,98,90,70,44,374,2806
E2489,94,97,72,41,70,374,2807
E2121,76,74,81,93,50,374,2808
E1911,91,47,66,99,71,374,2809
E8780,80,79,97,78,40,374,2810
E3190,79,98,42,72,83,374,2811
E5207,49,95,62,80,88,374,2812
E8285,90,81,48,74,81,374,2813
E2324,90,99,58,41,86,374,2814
E4657,93,95,75,49,62,374,2815
E8921,97,89,41,68,79,374,2816
E4384,100,53,41,98,82,374,2817
E9422,86,97,65,65,61,374,2818
E9583,98,98,91,47,40,374,2819
E3669,52,78,61,87,96,374,2820
E7239,67,69,69,91,78,374,2821
E1018,65,87,69,72,81,374,2822
E8447,85,100,59,52,78,374,2823
E2471,89,56,48,96,85,374,2824
E4327,58,95,74,72,75,374,2825
E1320,75,82,65,94,58,374,2826
E2962,94,63,66,75,76,374,2827
E7490,77,65,74,69,89,374,2828
E6405,64,80,88,83,59,374,2829
E2461,54,90,83,53,94,374,2830
E2347,65,94,57,86,72,374,2831
E0928,69,89,84,52,80,374,2832
E3708,70,84,65,91,64,374,2833
E8544,71,86,96,81,40,374,2834
E7916,52,69,88,91,74,374,2835
E1395,80,78,49,76,91,374,2836
E9161,87,79,93,48,67,374,2837
E0738,75,98,54,49,98,374,2838
E7100,99,100,71,53,51,374,2839
E0205,42,55,91,99,87,374,2840
E3985,100,79,55,96,44,374,2841
E3724,91,60,61,85,77,374,2842
E6589,81,78,69,64,82,374,2843
E7631,71,77,93,46,87,374,2844
E8179,99,60,50,70,95,374,2845
E0355,94,70,85,82,43,374,2846
E9560,84,84,51,67,88,374,2847
E6288,60,79,76,97,62,374,2848
E1249,98,86,58,49,83,374,2849
E7518,99,52,44,83,96,374,2850
E2329,99,93,54,57,71,374,2851
E3298,69,65,78,91,71,374,2852
E2829,71,58,92,54,99,374,2853
E9299,46,85,79,66,98,374,2854
E3836,83,98,61,65,67,374,2855
E9751,89,71,59,70,85,374,2856
E5105,82,50,99,97,46,374,2857
E9758,67,86,68,58,94,373,2858
E3258,51,89,49,86,98,373,2859
E2584,43,87,92,100,51,373,2860
E1761,79,78,91,74,51,373,2861
E7453,72,71,76,61,93,373,2862
E0395,77,70,100,51,75,373,2863
E8539,88,64,83,93,45,373,2864
E6688,42,90,91,96,54,373,2865
E1792,68,98,67,50,90,373,2866
E3467,59,84,83,70,77,373,2867
E3435,80,50,81,100,62,373,2868
E5531,67,89,67,71,79,373,2869
E0881,58,88,95,67,65,373,2870
E3705,75,87,57,86,68,373,2871
E5962,69,53,87,85,79,373,2872
E3813,91,95,74,52,61,373,2873
E0678,73,67,68,87,78,373,2874
E2765,100,77,57,72,67,373,2875
E4654,67,100,53,85,68,373,2876
E2948,81,85,77,57,73,373,2877
E3745,49,93,52,91,88,373,2878
E7448,40,94,76,75,88,373,2879
E9908,77,60,95,43,98,373,2880
E0162,93,98,52,89,41,373,2881
E3372,61,85,91,65,71,373,2882
E4413,51,64,97,68,93,373,2883
E6139,73,78,75,93,54,373,2884
E6378,81,40,72,90,90,373,2885
E7020,74,97,76,48,78,373,2886
E7599,82,93,63,87,48,373,2887
E4964,65,51,79,87,91,373,2888
E7063,92,69,80,58,74,373,2889
E2015,74,84,73,49,93,373,2890
E9789,80,65,69,81,78,373,2891
E6811,73,50,93,61,96,373,2892
E7353,77,55,89,94,58,373,2893
E8853,50,73,90,71,89,373,2894
E6131,82,60,60,91,80,373,2895
E2267,66,65,74,78,90,373,2896
E8936,58,56,78,95,86,373,2897
E8429,70,100,51,78,74,373,2898
E0719,70,99,50,96,58,373,2899
E9083,75,41,71,96,90,373,2900
E5740,95,88,46,79,65,373,2901
E7261,86,44,73,82,88,373,2902
E2900,93,68,55,64,93,373,2903
E9801,64,69,61,99,80,373,2904
E9264,71,59,80,66,97,373,2905
E1383,73,82,82,77,59,373,2906
E9946,78,93,67,64,71,373,2907
E7147,50,91,52,96,84,373,2908
E1572,62,95,87,67,62,373,2909
E0477,82,49,89,81,72,373,2910
E7595,91,87,72,82,41,373,2911
E6723,62,100,78,62,71,373,2912
E2055,59,67,91,58,98,373,2913
E4936,56,53,100,66,98,373,2914
E4598,97,91,74,70,41,373,2915
E5028,72,55,81,100,65,373,2916
E4092,73,47,73,84,96,373,2917
E4501,91,42,79,90,71,373,2918
E9976,88,69,48,81,87,373,2919
E5308,75,49,64,90,95,373,2920
E0072,75,57,88,57,96,373,2921
E6193,53,95,85,43,97,373,2922
E1448,79,87,84,54,69,373,2923
E4163,96,59,62,71,85,373,2924
E3950,55,83,71,65,99,373,2925
E2271,90,72,66,67,78,373,2926
E3158,57,83,94,53,86,373,2927
E5547,84,77,90,51,71,373,2928
E7537,64,83,48,91,87,373,2929
E5081,91,87,69,84,42,373,2930
E2903,79,61,86,54,93,373,2931
E8876,84,88,77,40,84,373,2932
E7437,47,77,88,65,96,373,2933
E6616,79,94,83,50,67,373,2934
E4115,50,83,98,48,94,373,2935
E6455,67,68,81,77,80,373,2936
E0417,92,56,66,84,75,373,2937
E8222,80,98,95,50,50,373,2938
E5107,41,95,62,79,96,373,2939
E5778,84,61,85,69,74,373,2940
E5394,66,80,70,68,88,372,2941
E0979,93,74,47,60,98,372,2942
E0851,96,60,99,40,77,372,2943
E8423,94,72,51,99,56,372,2944
E2653,86,55,73,87,71,372,2945
E5514,64,82,94,43,89,372,2946
E5878,59,93,92,75,53,372,2947
E9316,44,72,81,88,87,372,2948
E0509,47,82,99,92,52,372,2949
E2989,90,64,80,41,97,372,2950
E7878,95,95,60,65,57,372,2951
E6749,85,67,89,84,47,372,2952
E8016,88,91,53,75,65,372,2953
E9514,87,88,83,41,73,372,2954
E1120,94,67,78,84,49,372,2955
E7821,91,69,50,79,83,372,2956
E9691,100,71,77,64,60,372,2957
E2570,75,97,84,51,65,372,2958
E6027,46,72,97,87,70,372,2959
E3607,49,97,56,71,99,372,2960
E7894,55,49,77,96,95,372,2961
E0874,45,93,58,96,80,372,2962
E5947,59,52,100,67,94,372,2963
E7729,94,58,44,90,86,372,2964
E3245,70,40,74,100,88,372,2965
E7432,95,77,67,91,42,372,2966
E2170,62,68,90,64,88,372,2967
E9745,86,68,84,94,40,372,2968
E9443,94,95,70,44,69,372,2969
E9226,77,65,94,74,62,372,2970
E5076,60,61,72,85,94,372,2971
E6961,78,99,41,97,57,372,2972
E9820,84,47,74,79,88,372,2973
E8321,77,48,95,66,86,372,2974
E8000,93,52,84,76,67,372,2975
E1315,70,41,100,90,71,372,2976
E9995,70,85,86,52,79,372,2977
E5971,100,58,76,70,68,372,2978
E4695,46,98,78,78,72,372,2979
E3683,97,94,57,78,46,372,2980
E6669,62,73,53,84,100,372,2981
E9408,97,92,70,52,61,372,2982
E2291,81,65,73,77,76,372,2983
E3585,71,51,88,74,88,372,2984
E8076,72,45,96,61,98,372,2985
E3300,69,64,80,74,85,372,2986
E6772,61,83,66,79,83,372,2987
E6884,92,52,95,85,48,372,2988
E4393,62,89,88,85,48,372,2989
E4427,40,73,96,95,68,372,2990
E2914,70,43,91,85,83,372,2991
E1155,88,59,74,69,82,372,2992
E5073,90,53,87,97,45,372,2993
E8019,91,79,50,100,52,372,2994
E9195,53,80,97,65,77,372,2995
E7246,96,94,89,50,43,372,2996
E8904,71,48,100,69,84,372,2997
E7435,92,51,57,96,76,372,2998
E3021,44,97,62,88,81,372,2999
E6298,89,66,74,96,47,372,3000
E8049,77,86,84,51,74,372,3001
E6402,46,80,88,81,77,372,3002
E8062,64,84,62,67,95,372,3003
E1782,86,69,61,96,60,372,3004
E4013,77,66,98,78,53,372,3005
E2875,45,80,87,100,60,372,3006
E8098,76,88,77,88,43,372,3007
E0635,74,91,51,66,90,372,3008
E9543,85,81,90,44,72,372,3009
E0885,67,72,66,97,70,372,3010
E5554,65,63,87,94,63,372,3011
E9565,66,68,94,66,78,372,3012
E9701,91,64,43,83,91,372,3013
E3399,86,77,41,91,77,372,3014
E1841,77,68,48,86,93,372,3015
E0695,99,98,68,64,43,372,3016
E5281,77,64,94,78,59,372,3017
E1334,96,60,53,69,94,372,3018
E0315,73,54,95,64,86,372,3019
E8415,93,55,84,94,46,372,3020
E2810,79,43,82,71,97,372,3021
E9714,89,54,92,85,52,372,3022
E1035,100,48,83,93,48,372,3023
E6725,85,53,63,77,94,372,3024
E6358,59,79,98,93,43,372,3025
E4414,74,70,63,91,74,372,3026
E6727,77,67,86,43,99,372,3027
E3326,97,75,52,90,58,372,3028
E0742,82,43,93,100,54,372,3029
E5181,46,89,81,74,82,372,3030
E6023,41,71,83,87,90,372,3031
E7882,92,52,45,86,97,372,3032
E9174,98,82,52,69,71,372,3033
E7484,41,54,99,86,92,372,3034
E2025,67,78,62,73,91,371,3035
E5699,87,88,93,41,62,371,3036
E7877,86,73,67,72,73,371,3037
E1111,55,81,85,63,87,371,3038
E3892,95,97,57,65,57,371,3039
E8181,91,55,57,87,81,371,3040
E3934,59,89,72,74,77,371,3041
E0675,71,74,90,49,87,371,3042
E3581,54,88,97,68,64,371,3043
E3511,79,51,65,79,97,371,3044
E4099,90,63,59,76,83,371,3045
E1714,80,71,95,65,60,371,3046
E9276,49,64,92,78,88,371,3047
E4692,87,58,85,68,73,371,3048
E9684,48,76,55,94,98,371,3049
E2093,76,91,86,69,49,371,3050
E6887,76,75,97,54,69,371,3051
E6613,71,78,100,77,45,371,3052
E9353,90,64,88,60,69,371,3053
E5663,65,60,69,95,82,371,3054
E1446,63,89,90,83,46,371,3055
E6302,85,69,73,53,91,371,3056
E4663,91,88,96,56,40,371,3057
E9719,56,100,93,75,47,371,3058
E0613,89,58,87,80,57,371,3059
E4982,100,89,59,80,43,371,3060
E6821,95,77,61,68,70,371,3061
E5530,50,66,93,89,73,371,3062
E8241,71,65,81,92,62,371,3063
E3992,62,76,98,42,93,371,3064
E1055,77,84,88,55,67,371,3065
E4601,65,61,99,90,56,371,3066
E5358,99,87,50,55,80,371,3067
E2717,78,69,47,83,94,371,3068
E1057,96,88,47,55,85,371,3069
E1394,50,75,78,96,72,371,3070
E4243,65,95,54,100,57,371,3071
E5587,83,84,59,91,54,371,3072
E4899,59,63,89,93,67,371,3073
E5118,67,89,63,71,81,371,3074
E3385,48,88,90,89,56,371,3075
E9512,54,100,71,68,78,371,3076
E7101,97,50,57,93,74,371,3077
E1039,87,57,81,88,58,371,3078
E0379,80,84,67,90,50,371,3079
E8013,68,47,96,74,86,371,3080
E8643,70,61,57,99,84,371,3081
E3798,86,93,63,80,49,371,3082
E9015,54,100,86,62,69,371,3083
E8717,50,71,75,98,77,371,3084
E1855,100,44,77,58,92,371,3085
E6035,80,82,40,92,77,371,3086
E5982,84,49,94,85,59,371,3087
E5795,78,86,80,85,42,371,3088
E4106,66,73,55,89,88,371,3089
E9850,80,51,57,88,95,371,3090
E9260,72,96,56,73,74,371,3091
E9625,74,69,65,82,81,371,3092
E5347,51,97,74,99,50,371,3093
E8051,56,57,99,71,88,371,3094
E3259,93,48,40,100,90,371,3095
E9086,55,89,58,92,77,371,3096
E8975,96,71,51,82,71,371,3097
E5549,68,95,58,89,61,371,3098
E1080,95,40,66,98,72,371,3099
E0849,80,87,71,50,83,371,3100
E3486,71,81,75,47,97,371,3101
E2544,89,86,79,48,69,371,3102
E5868,92,66,80,91,42,371,3103
E5065,91,90,53,66,71,371,3104
E8594,54,80,86,69,82,371,3105
E8696,93,96,42,43,97,371,3106
E6680,95,71,93,68,44,371,3107
E9621,53,87,93,54,84,371,3108
E5506,64,42,86,96,83,371,3109
E3359,73,85,90,52,71,371,3110
E5471,98,76,49,61,87,371,3111
E6868,56,78,97,83,57,371,3112
E4340,53,71,79,69,99,371,3113
E7492,86,89,52,51,93,371,3114
E4407,94,42,48,90,97,371,3115
E0958,69,67,74,68,93,371,3116
E6307,76,72,74,51,98,371,3117
E6048,80,48,77,66,100,371,3118
E1538,85,64,72,81,69,371,3119
E0850,55,48,85,97,86,371,3120
E1913,100,74,50,83,64,371,3121
E2608,71,86,83,91,40,371,3122
E1433,84,84,83,58,62,371,3123
E7735,58,72,89,93,59,371,3124
E6389,85,89,60,43,94,371,3125
E5176,83,80,78,58,72,371,3126
E0127,72,90,70,61,78,371,3127
E0491,62,99,72,90,48,371,3128
E6184,80,52,75,89,74,370,3129
E3785,72,49,86,67,96,370,3130
E0605,73,68,48,89,92,370,3131
E3655,56,93,69,76,76,370,3132
E9720,49,63,91,89,78,370,3133
E5516,86,82,60,92,50,370,3134
E4134,83,67,62,75,83,370,3135
E5169,52,91,84,92,51,370,3136
E9077,97,51,80,78,64,370,3137
E9522,100,74,83,68,45,370,3138
E5798,67,74,47,93,89,370,3139
E1445,57,59,93,78,83,370,3140
E7315,78,43,80,99,70,370,3141
E5808,89,63,81,54,83,370,3142
E2742,86,83,89,40,72,370,3143
E2982,99,50,73,72,76,370,3144
E6482,42,99,62,88,79,370,3145
E8647,73,96,46,79,76,370,3146
E2701,69,80,81,65,75,370,3147
E3160,74,61,79,90,66,370,3148
E0837,66,95,88,61,60,370,3149
E0980,93,77,60,98,42,370,3150
E5555,71,75,52,81,91,370,3151
E8250,47,81,88,60,94,370,3152
E9737,60,93,67,92,58,370,3153
E1970,73,59,44,96,98,370,3154
E5027,63,85,91,54,77,370,3155
E6282,99,69,52,89,61,370,3156
E1515,96,57,77,81,59,370,3157
E9563,78,58,72,88,74,370,3158
E9503,98,72,64,73,63,370,3159
E0727,56,84,91,51,88,370,3160
E2927,67,86,93,77,47,370,3161
E3222,67,88,79,52,84,370,3162
E5294,92,70,52,100,56,370,3163
E5472,57,65,100,86,62,370,3164
E4252,61,98,61,52,98,370,3165
E6581,73,98,89,70,40,370,3166
E3979,64,83,55,92,76,370,3167
E7645,48,91,52,82,97,370,3168
E1207,66,91,68,51,94,370,3169
E5925,91,55,96,52,76,370,3170
E0336,87,48,83,58,94,370,3171
E4799,71,84,97,68,50,370,3172
E4491,85,95,51,89,50,370,3173
E3605,77,85,90,71,47,370,3174
E6953,44,94,75,90,67,370,3175
E4228,80,65,91,51,83,370,3176
E1852,48,49,86,90,97,370,3177
E3145,97,64,76,42,91,370,3178
E3094,84,90,94,46,56,370,3179
E8540,61,57,99,84,69,370,3180
E5986,70,49,84,77,90,370,3181
E0815,49,95,83,88,55,370,3182
E6128,94,62,90,49,75,370,3183
E7706,75,100,71,62,62,370,3184
E4206,83,82,89,65,51,370,3185
E9281,96,80,94,48,52,370,3186
E2710,41,100,49,86,94,370,3187
E0368,64,78,61,80,87,370,3188
E5803,96,77,47,69,81,370,3189
E7627,99,73,62,64,72,370,3190
E3460,93,73,58,84,62,370,3191
E1799,82,93,54,96,45,370,3192
E1706,60,52,87,79,92,370,3193
E2668,59,98,63,71,79,370,3194
E3782,75,59,91,89,56,370,3195
E2549,80,97,87,66,40,370,3196
E7691,63,78,69,84,76,370,3197
E6099,85,43,91,63,88,370,3198
E5662,90,55,78,98,49,370,3199
E7317,89,44,68,69,100,370,3200
E3030,100,62,60,48,100,370,3201
E2583,85,53,96,84,52,370,3202
E3321,85,98,42,56,88,369,3203
E2338,76,55,98,98,42,369,3204
E5095,76,45,89,100,59,369,3205
E6369,90,65,74,91,49,369,3206
E0073,91,57,43,93,85,369,3207
E3065,65,48,63,94,99,369,3208
E4124,69,48,78,88,86,369,3209
E5403,63,76,92,92,46,369,3210
E3828,86,83,76,79,45,369,3211
E9598,65,93,48,90,73,369,3212
E2548,48,83,52,86,100,369,3213
E5919,75,100,52,48,94,369,3214
E2816,86,76,52,68,87,369,3215
E7171,85,53,80,65,86,369,3216
E1305,62,51,89,70,97,369,3217
E3146,57,60,92,76,84,369,3218
E4128,67,51,90,90,71,369,3219
E6807,64,51,71,97,86,369,3220
E4127,85,67,67,96,54,369,3221
E6699,98,41,86,96,48,369,3222
E0713,100,73,82,63,51,369,3223
E0071,56,82,92,66,73,369,3224
E7667,78,81,77,76,57,369,3225
E4715,57,70,67,91,84,369,3226
E9493,65,72,55,93,84,369,3227
E4493,68,81,95,73,52,369,3228
E2019,53,96,63,74,83,369,3229
E5386,46,65,94,87,77,369,3230
E3312,74,83,84,57,71,369,3231
E1904,45,99,91,92,42,369,3232
E8974,68,99,45,64,93,369,3233
E2018,58,85,94,72,60,369,3234
E5895,93,60,89,68,59,369,3235
E0055,81,77,77,67,67,369,3236
E4431,74,85,46,65,99,369,3237
E4385,84,74,93,40,78,369,3238
E9680,61,74,49,91,94,369,3239
E6216,74,98,62,90,45,369,3240
E1637,67,71,87,62,82,369,3241
E8693,88,82,98,59,42,369,3242
E8469,99,64,42,65,99,369,3243
E9364,49,65,100,88,67,369,3244
E8817,83,40,78,70,98,369,3245
E9234,87,95,70,69,48,369,3246
E3441,68,85,76,40,100,369,3247
E4792,99,51,97,48,74,369,3248
E7162,43,98,47,81,100,369,3249
E1254,66,90,71,88,54,369,3250
E6944,71,89,80,51,78,369,3251
E4886,89,94,97,47,42,369,3252
E6802,64,93,66,66,80,369,3253
E3825,72,85,100,49,63,369,3254
E8589,76,41,86,68,98,369,3255
E9594,40,85,96,62,86,369,3256
E9660,63,55,85,100,66,369,3257
E4969,61,95,99,69,45,369,3258
E8483,62,76,76,78,77,369,3259
E1482,54,94,89,70,62,369,3260
E6917,70,82,77,78,62,369,3261
E8219,99,59,77,43,91,369,3262
E8949,78,63,76,84,68,369,3263
E5464,70,42,98,75,84,369,3264
E6511,93,45,85,53,93,369,3265
E0321,90,51,94,51,83,369,3266
E9141,78,83,63,61,84,369,3267
E9665,74,71,42,91,91,369,3268
E3943,78,82,43,91,75,369,3269
E9695,89,81,57,88,54,369,3270
E2384,86,62,81,50,90,369,3271
E8278,89,57,77,93,53,369,3272
E9746,77,97,54,47,94,369,3273
E6373,100,45,79,62,83,369,3274
E8186,84,53,97,47,88,369,3275
E9347,41,92,94,55,87,369,3276
E6576,99,76,65,52,77,369,3277
E7531,77,62,77,89,64,369,3278
E9729,58,96,43,74,98,369,3279
E5320,96,53,69,55,96,369,3280
E7694,54,67,100,74,74,369,3281
E1067,49,97,52,82,89,369,3282
E9456,92,61,79,73,64,369,3283
E4324,45,84,96,95,49,369,3284
E3039,52,87,98,40,92,369,3285
E7495,63,90,86,55,75,369,3286
E0392,94,92,48,42,93,369,3287
E3411,71,93,72,90,43,369,3288
E2984,49,81,88,87,64,369,3289
E0371,72,99,57,41,100,369,3290
E9474,65,57,58,91,98,369,3291
E0612,73,72,76,97,51,369,3292
E7813,48,54,95,93,79,369,3293
E7087,94,95,67,68,45,369,3294
E9024,47,91,84,60,87,369,3295
E4528,53,88,97,40,91,369,3296
E5503,99,51,61,92,66,369,3297
E4091,52,81,50,96,90,369,3298
E7828,49,92,100,79,49,369,3299
E0748,41,83,63,94,88,369,3300
E6602,88,42,64,99,76,369,3301
E9642,59,55,91,97,67,369,3302
E3776,54,84,100,52,79,369,3303
E3686,73,53,55,95,93,369,3304
E0381,86,99,40,72,72,369,3305
E4711,48,78,90,52,100,368,3306
E0731,78,71,97,71,51,368,3307
E2498,74,78,79,41,96,368,3308
E0639,62,73,85,84,64,368,3309
E2368,80,96,47,88,57,368,3310
E2760,84,88,43,90,63,368,3311
E3212,90,62,55,89,72,368,3312
E8120,85,58,83,61,81,368,3313
E6198,91,99,54,81,43,368,3314
E1619,63,55,63,87,100,368,3315
E8640,65,77,79,61,86,368,3316
E9178,97,65,86,80,40,368,3317
E1917,80,52,92,92,52,368,3318
E4707,66,87,99,46,70,368,3319
E1849,53,54,87,79,95,368,3320
E3031,89,100,41,92,46,368,3321
E9981,80,50,89,90,59,368,3322
E0153,81,78,72,88,49,368,3323
E3600,40,84,91,73,80,368,3324
E1996,86,79,42,77,84,368,3325
E2834,61,57,92,81,77,368,3326
E9799,80,85,47,79,77,368,3327
E1636,93,57,61,91,66,368,3328
E5026,56,91,48,100,73,368,3329
E4565,87,47,70,98,66,368,3330
E8300,56,90,64,67,91,368,3331
E5279,77,79,77,85,50,368,3332
E2891,75,69,71,83,70,368,3333
E7109,59,90,57,91,71,368,3334
E8520,76,75,76,63,78,368,3335
E7529,93,47,60,82,86,368,3336
E5648,78,70,67,89,64,368,3337
E1264,55,49,95,70,99,368,3338
E7026,97,74,74,58,65,368,3339
E5362,56,94,63,88,67,368,3340
E8861,69,79,85,74,61,368,3341
E8969,66,75,81,88,58,368,3342
E5793,92,60,93,55,68,368,3343
E1650,66,58,89,95,60,368,3344
E1393,91,65,95,71,46,368,3345
E3622,44,56,84,90,94,368,3346
E9058,71,70,58,75,94,368,3347
E3449,80,93,84,67,44,368,3348
E8187,88,75,61,60,84,368,3349
E0047,43,67,76,83,99,368,3350
E3779,81,54,70,65,98,368,3351
E9349,87,46,96,41,98,368,3352
E9046,99,68,41,98,62,368,3353
E4332,92,65,90,80,41,368,3354
E6096,43,83,96,100,46,368,3355
E5239,96,65,69,58,80,368,3356
E1397,85,98,73,66,46,368,3357
E6911,81,75,56,80,76,368,3358
E2582,89,92,66,63,58,368,3359
E9692,49,55,69,97,98,368,3360
E1900,61,88,71,98,50,368,3361
E8361,61,94,53,99,61,368,3362
E7576,62,97,80,72,57,368,3363
E5603,84,40,79,97,68,368,3364
E6946,71,73,68,73,83,368,3365
E5874,55,68,82,98,65,368,3366
E6021,81,74,64,94,55,368,3367
E6293,64,43,83,84,94,368,3368
E4114,96,60,72,94,46,368,3369
E7573,75,79,40,94,80,368,3370
E1236,54,61,81,86,86,368,3371
E9230,57,77,83,100,51,368,3372
E8562,92,47,57,81,91,368,3373
E0453,100,43,56,71,98,368,3374
E4803,80,45,67,89,87,368,3375
E4450,89,71,47,85,76,368,3376
E3667,55,85,97,57,74,368,3377
E7423,46,85,84,59,94,368,3378
E4512,47,74,72,79,96,368,3379
E9055,77,70,65,76,80,368,3380
E2327,96,100,66,48,58,368,3381
E6138,89,57,74,81,67,368,3382
E4587,90,65,68,88,57,368,3383
E5644,98,70,50,83,67,368,3384
E7811,85,76,91,57,58,367,3385
E6977,55,63,84,73,92,367,3386
E1293,90,50,87,85,55,367,3387
E8943,95,96,47,80,49,367,3388
E1272,40,87,73,92,75,367,3389
E1755,95,92,61,67,52,367,3390
E5229,50,85,79,77,76,367,3391
E8213,81,59,58,99,70,367,3392
E1074,86,41,75,76,89,367,3393
E6777,45,81,70,96,75,367,3394
E8436,48,79,59,82,99,367,3395
E8170,64,60,80,69,94,367,3396
E2273,87,48,85,47,100,367,3397
E4521,42,82,75,70,98,367,3398
E6073,65,95,100,45,62,367,3399
E0501,93,82,59,48,85,367,3400
E2674,93,62,53,75,84,367,3401
E3717,73,80,56,78,80,367,3402
E4492,90,52,72,65,88,367,3403
E7855,57,74,94,98,44,367,3404
E0953,94,85,55,45,88,367,3405
E1294,65,44,93,99,66,367,3406
E2770,97,77,55,47,91,367,3407
E3412,85,66,53,84,79,367,3408
E1654,99,54,90,54,70,367,3409
E1789,90,86,52,62,77,367,3410
E1686,60,78,88,78,63,367,3411
E7563,74,47,86,75,85,367,3412
E0268,63,85,69,69,81,367,3413
E1106,65,99,53,74,76,367,3414
E3656,99,99,46,64,59,367,3415
E5626,90,77,74,71,55,367,3416
E6014,84,91,62,66,64,367,3417
E8193,78,63,86,62,78,367,3418
E2892,92,70,95,41,69,367,3419
E5044,81,94,72,74,46,367,3420
E9381,69,69,97,71,61,367,3421
E4378,94,71,50,76,76,367,3422
E2543,81,66,96,51,73,367,3423
E5290,92,69,68,65,73,367,3424
E2735,91,66,75,72,63,367,3425
E3624,79,91,48,61,88,367,3426
E5910,68,72,52,91,84,367,3427
E3398,78,68,59,80,82,367,3428
E8633,100,84,57,71,55,367,3429
E7390,90,77,71,44,85,367,3430
E5210,94,79,40,64,90,367,3431
E5116,69,90,51,77,80,367,3432
E5264,83,92,65,49,78,367,3433
E7779,89,84,56,94,44,367,3434
E9442,63,42,72,90,100,367,3435
E5456,95,61,77,41,93,367,3436
E3910,92,73,54,60,88,367,3437
E2884,80,78,41,73,95,367,3438
E4399,86,55,55,93,78,367,3439
E5836,89,84,67,51,76,367,3440
E3456,71,99,80,64,53,367,3441
E6677,64,60,70,78,95,367,3442
E2567,97,87,76,61,46,367,3443
E7166,92,77,89,52,57,367,3444
E5321,47,99,41,83,97,367,3445
E0516,65,96,76,41,89,367,3446
E2459,61,66,75,81,84,367,3447
E1286,46,95,77,82,67,367,3448
E6055,85,62,87,56,77,367,3449
E6350,87,45,43,97,95,367,3450
E1786,81,95,53,59,79,367,3451
E7571,88,98,53,81,47,367,3452
E3490,96,46,99,44,82,367,3453
E0189,77,56,88,68,78,367,3454
E7050,86,93,53,66,69,367,3455
E2345,55,85,98,84,45,367,3456
E7469,70,92,43,64,98,367,3457
E1580,58,99,78,77,55,367,3458
E7677,59,93,44,77,94,367,3459
E2551,58,93,98,51,67,367,3460
E9126,73,68,76,67,82,366,3461
E3721,76,90,78,61,61,366,3462
E3466,42,77,89,81,77,366,3463
E8842,85,92,40,88,61,366,3464
E3276,60,73,94,43,96,366,3465
E6775,63,57,56,91,99,366,3466
E7590,62,75,89,63,77,366,3467
E9561,71,59,64,99,73,366,3468
E8302,96,47,67,65,91,366,3469
E0653,87,70,94,63,52,366,3470
E1014,68,81,68,64,85,366,3471
E8080,80,72,82,56,76,366,3472
E1396,56,88,60,86,76,366,3473
E3647,83,53,85,85,60,366,3474
E6766,96,53,90,69,58,366,3475
E2135,91,80,74,55,66,366,3476
E3879,69,45,88,88,76,366,3477
E0932,46,92,91,64,73,366,3478
E9328,53,56,92,97,68,366,3479
E0588,88,62,71,96,49,366,3480
E6316,88,67,55,68,88,366,3481
E9972,63,95,69,87,52,366,3482
E0674,94,64,87,47,74,366,3483
E3074,64,70,99,49,84,366,3484
E0345,59,94,59,79,75,366,3485
E3649,73,70,64,65,94,366,3486
E7653,47,93,95,87,44,366,3487
E8698,45,71,96,83,71,366,3488
E5593,68,89,88,49,72,366,3489
E4000,93,65,69,73,66,366,3490
E6857,79,72,55,96,64,366,3491
E1150,74,61,45,94,92,366,3492
E1162,58,76,94,90,48,366,3493
E7187,94,76,79,52,65,366,3494
E8237,75,77,92,60,62,366,3495
E0587,89,63,60,83,71,366,3496
E6905,92,57,57,94,66,366,3497
E2097,43,86,83,73,81,366,3498
E7067,49,84,78,93,62,366,3499
E5683,46,98,68,88,66,366,3500
E0045,43,95,91,83,54,366,3501
E8584,100,63,60,44,99,366,3502
E8803,63,74,93,56,80,366,3503
E3407,76,59,78,66,87,366,3504
E4580,53,95,95,68,55,366,3505
E2767,72,92,66,85,51,366,3506
E9062,65,47,97,100,57,366,3507
E9021,83,53,43,89,98,366,3508
E3139,79,77,69,55,86,366,3509
E6763,77,94,61,85,49,366,3510
E2513,88,75,60,83,60,366,3511
E8165,60,76,47,96,87,366,3512
E0615,86,90,75,49,66,366,3513
E1871,82,79,59,80,66,366,3514
E2153,46,92,96,69,63,366,3515
E7269,46,86,51,85,98,366,3516
E2062,77,83,42,99,65,366,3517
E7370,70,90,61,99,46,366,3518
E6204,76,72,79,81,58,366,3519
E1322,85,96,60,60,65,366,3520
E6846,52,95,74,93,52,366,3521
E5205,73,53,73,78,89,366,3522
E5659,69,88,91,40,78,366,3523
E2615,56,76,84,72,78,366,3524
E3930,64,71,97,63,71,366,3525
E1933,67,65,87,95,52,366,3526
E2950,86,69,96,43,72,366,3527
E7635,65,54,89,73,85,366,3528
E6930,54,46,73,93,100,366,3529
E2175,61,70,71,75,89,366,3530
E8435,77,100,48,84,57,366,3531
E2026,41,76,79,99,71,366,3532
E6263,85,100,52,59,70,366,3533
E8433,55,94,86,51,80,366,3534
E3547,66,87,43,85,85,366,3535
E9450,79,65,92,63,67,366,3536
E5873,100,45,48,87,86,366,3537
E6767,85,55,90,59,77,366,3538
E5404,64,81,95,52,74,366,3539
E3126,84,99,79,64,40,366,3540
E4751,99,72,86,42,67,366,3541
E4392,46,86,98,54,82,366,3542
E5902,54,82,61,89,80,366,3543
E4849,52,75,84,69,86,366,3544
E4674,70,44,100,57,95,366,3545
E2638,43,81,81,100,60,365,3546
E8041,79,64,41,87,94,365,3547
E2022,48,90,56,71,100,365,3548
E8681,78,46,75,80,86,365,3549
E3856,57,84,81,96,47,365,3550
E5592,81,57,66,69,92,365,3551
E5334,94,87,45,96,43,365,3552
E8889,99,78,52,85,51,365,3553
E2414,50,70,94,84,67,365,3554
E6829,87,59,64,84,71,365,3555
E1387,64,68,99,46,88,365,3556
E0370,54,72,67,74,98,365,3557
E0106,65,95,48,59,98,365,3558
E4838,51,69,53,95,97,365,3559
E8712,77,70,47,86,85,365,3560
E0401,70,97,65,42,91,365,3561
E8161,43,82,51,96,93,365,3562
E5156,99,100,68,40,58,365,3563
E1049,78,74,76,94,43,365,3564
E2855,74,86,75,47,83,365,3565
E7837,75,81,79,40,90,365,3566
E3845,98,65,70,85,47,365,3567
E6442,68,80,68,60,89,365,3568
E0469,73,80,69,78,65,365,3569
E0278,77,99,47,61,81,365,3570
E3613,90,80,85,49,61,365,3571
E9108,95,94,42,63,71,365,3572
E7367,57,77,79,56,96,365,3573
E9100,75,97,62,62,69,365,3574
E8674,88,68,69,97,43,365,3575
E1560,74,42,83,85,81,365,3576
E9468,95,40,50,87,93,365,3577
E6547,86,52,72,75,80,365,3578
E8245,52,92,93,64,64,365,3579
E5863,78,72,81,80,54,365,3580
E8620,94,95,52,44,80,365,3581
E8218,62,51,82,99,71,365,3582
E3839,81,66,43,86,89,365,3583
E5797,78,57,68,74,88,365,3584
E5200,81,92,41,66,85,365,3585
E1530,82,64,87,53,79,365,3586
E9809,72,72,41,91,89,365,3587
E8346,44,77,61,98,85,365,3588
E6170,69,66,88,47,95,365,3589
E7004,69,57,60,86,93,365,3590
E5543,85,42,87,65,86,365,3591
E7915,98,69,42,88,68,365,3592
E1978,62,77,61,84,81,365,3593
E6531,69,94,55,91,56,365,3594
E4929,54,89,77,49,96,365,3595
E5560,51,76,87,81,70,365,3596
E1894,52,100,63,83,67,365,3597
E9382,98,60,66,83,58,365,3598
E7243,50,51,76,89,99,365,3599
E1962,95,56,75,99,40,365,3600
E2056,56,70,53,95,91,365,3601
E5780,41,77,95,88,64,365,3602
E0136,70,95,54,86,60,365,3603
E1141,48,78,76,68,95,365,3604
E6311,78,43,62,95,87,365,3605
E0576,49,75,70,95,76,365,3606
E9423,77,69,44,95,80,365,3607
E1959,88,93,54,52,78,365,3608
E3171,99,44,51,97,74,365,3609
E4344,44,99,87,76,59,365,3610
E2974,62,100,65,96,42,365,3611
E5825,91,66,61,77,70,365,3612
E3017,71,50,77,91,76,365,3613
E8918,87,49,94,42,93,365,3614
E3928,56,77,73,92,67,365,3615
E1061,62,68,95,90,50,365,3616
E2798,86,57,76,91,55,365,3617
E9873,54,77,60,79,95,365,3618
E9336,96,73,79,67,50,365,3619
E8970,74,41,94,79,77,365,3620
E3854,69,74,99,54,69,365,3621
E8684,87,79,65,50,84,365,3622
E4791,99,70,64,59,73,365,3623
E5253,99,77,49,85,55,365,3624
E8873,72,85,75,71,62,365,3625
E3473,82,85,41,96,61,365,3626
E5466,46,80,67,88,84,365,3627
E4032,71,73,81,68,72,365,3628
E3833,58,75,86,66,80,365,3629
E9592,47,98,41,94,85,365,3630
E8177,78,75,47,80,85,365,3631
E8363,98,57,55,59,96,365,3632
E6971,66,71,76,73,79,365,3633
E7873,41,56,88,90,90,365,3634
E4629,84,65,89,69,58,365,3635
E1708,97,63,72,52,81,365,3636
E0968,92,61,91,79,42,365,3637
E6824,83,56,93,76,57,365,3638
E9265,77,53,65,94,76,365,3639
E8573,79,93,87,42,64,365,3640
E8816,93,64,66,79,63,365,3641
E5966,69,88,67,71,70,365,3642
E4250,63,61,88,61,92,365,3643
E7010,76,92,48,87,62,365,3644
E3150,94,71,88,66,46,365,3645
E8791,69,82,59,74,81,365,3646
E3246,98,96,45,54,72,365,3647
E9220,92,52,67,77,77,365,3648
E7564,57,92,63,94,59,365,3649
E6287,51,93,45,100,76,365,3650
E9894,99,59,76,52,79,365,3651
E9419,100,45,57,64,99,365,3652
E0693,42,96,74,85,68,365,3653
E8052,61,95,77,89,43,365,3654
E8802,80,71,75,75,64,365,3655
E4551,60,87,68,57,92,364,3656
E3439,77,66,85,72,64,364,3657
E6719,83,94,55,79,53,364,3658
E7862,65,81,71,65,82,364,3659
E1262,70,89,64,92,49,364,3660
E9655,89,69,77,66,63,364,3661
E2103,88,58,52,70,96,364,3662
E1199,69,96,77,50,72,364,3663
E0814,53,55,97,65,94,364,3664
E8323,96,60,64,70,74,364,3665
E7575,57,94,60,87,66,364,3666
E0760,64,100,43,97,60,364,3667
E2579,52,97,50,73,92,364,3668
E0584,50,92,96,72,54,364,3669
E3260,52,83,95,77,57,364,3670
E2636,67,87,87,63,60,364,3671
E9579,89,62,69,64,80,364,3672
E7022,79,90,45,86,64,364,3673
E4858,55,61,100,73,75,364,3674
E4317,68,45,84,99,68,364,3675
E4908,58,75,59,100,72,364,3676
E3086,42,97,73,84,68,364,3677
E4600,66,76,65,85,72,364,3678
E2972,63,91,73,77,60,364,3679
E1436,69,100,87,61,47,364,3680
E9202,78,53,46,95,92,364,3681
E2894,74,60,51,98,81,364,3682
E8031,94,82,73,40,75,364,3683
E5572,72,52,96,87,57,364,3684
E3406,71,63,52,90,88,364,3685
E9593,92,40,71,79,82,364,3686
E1292,90,64,92,68,50,364,3687
E6019,68,93,58,77,68,364,3688
E5349,73,55,71,91,74,364,3689
E5715,72,53,70,99,70,364,3690
E0350,93,48,70,76,77,364,3691
E8304,90,50,75,70,79,364,3692
E5600,84,52,68,99,61,364,3693
E1715,43,97,98,49,77,364,3694
E8313,71,86,82,64,61,364,3695
E6548,98,58,58,64,86,364,3696
E8934,81,90,74,41,78,364,3697
E3116,75,60,99,87,43,364,3698
E3860,67,62,55,99,81,364,3699
E7754,57,61,76,80,90,364,3700
E3876,74,57,72,70,91,364,3701
E5748,57,72,90,45,100,364,3702
E5165,51,69,95,49,100,364,3703
E7552,68,86,99,40,71,364,3704
E7258,53,97,84,45,85,364,3705
E1110,70,80,49,84,81,364,3706
E6753,41,84,49,96,94,364,3707
E6101,74,48,74,73,95,364,3708
E9653,43,75,74,77,95,364,3709
E9890,87,86,85,40,66,364,3710
E9743,45,100,52,96,71,364,3711
E0821,75,93,70,71,55,364,3712
E9501,91,63,56,91,63,364,3713
E6156,50,78,89,47,100,364,3714
E0231,51,64,79,88,82,364,3715
E7136,73,89,49,81,72,364,3716
E8601,81,93,64,77,49,364,3717
E0022,88,55,92,55,74,364,3718
E7640,65,90,46,72,91,364,3719
E0873,53,91,55,90,75,364,3720
E3946,51,90,96,79,48,364,3721
E5132,77,60,79,63,85,364,3722
E6740,76,93,43,76,76,364,3723
E7017,73,81,70,100,40,364,3724
E5483,62,67,59,99,77,364,3725
E2044,96,73,55,61,79,364,3726
E2811,69,82,43,98,72,364,3727
E4337,65,98,65,46,90,364,3728
E2117,65,58,89,54,98,364,3729
E6509,47,87,86,70,74,364,3730
E4141,76,41,93,97,57,364,3731
E7226,63,46,96,100,59,364,3732
E1741,77,92,50,88,57,364,3733
E3068,65,66,80,65,88,364,3734
E6851,69,81,94,66,54,364,3735
E4464,86,74,87,72,45,364,3736
E5407,80,91,59,75,59,364,3737
E7493,45,93,98,87,41,364,3738
E0959,95,49,94,78,48,364,3739
E6552,63,60,77,94,70,364,3740
E1833,97,60,79,75,53,364,3741
E3972,79,99,77,54,54,363,3742
E4375,81,76,79,51,76,363,3743
E0822,82,51,93,82,55,363,3744
E3429,91,52,73,91,56,363,3745
E0471,83,64,70,46,100,363,3746
E6181,53,86,93,41,90,363,3747
E6773,88,87,52,74,62,363,3748
E7251,52,86,98,53,74,363,3749
E9441,47,87,95,93,41,363,3750
E5556,48,89,66,78,82,363,3751
E8521,97,82,65,43,76,363,3752
E5270,44,56,92,72,99,363,3753
E0933,73,90,91,46,63,363,3754
E1084,64,52,64,97,86,363,3755
E0010,88,62,85,55,73,363,3756
E9007,56,42,88,96,81,363,3757
E1301,75,49,65,84,90,363,3758
E7840,74,79,54,96,60,363,3759
E5886,58,64,89,61,91,363,3760
E7038,52,98,72,90,51,363,3761
E8838,61,60,55,93,94,363,3762
E1638,82,60,84,88,49,363,3763
E9080,87,70,98,54,54,363,3764
E5504,99,70,53,81,60,363,3765
E1498,94,61,50,99,59,363,3766
E5378,96,67,81,67,52,363,3767
E0101,100,71,67,61,64,363,3768
E7182,95,43,74,91,60,363,3769
E5709,97,77,83,49,57,363,3770
E8364,91,47,80,90,55,363,3771
E3772,92,92,63,46,70,363,3772
E7129,64,49,82,73,95,363,3773
E1937,85,75,76,49,78,363,3774
E0292,87,44,89,99,44,363,3775
E7211,44,61,88,70,100,363,3776
E0198,78,49,71,84,81,363,3777
E4281,45,62,77,83,96,363,3778
E9805,91,58,56,96,62,363,3779
E1930,76,73,99,72,43,363,3780
E7786,57,99,70,59,78,363,3781
E7741,59,77,78,99,50,363,3782
E2105,91,73,59,70,70,363,3783
E0544,65,77,61,86,74,363,3784
E9516,100,80,47,89,47,363,3785
E2718,53,89,76,100,45,363,3786
E1327,77,89,63,68,66,363,3787
E5800,51,72,74,69,97,363,3788
E1281,59,51,78,75,100,363,3789
E2657,87,72,56,56,92,363,3790
E1222,97,56,41,74,95,363,3791
E1480,77,75,93,46,72,363,3792
E2618,50,67,76,86,84,363,3793
E3732,51,95,63,78,76,363,3794
E0879,91,46,99,79,48,363,3795
E2929,75,71,61,67,89,363,3796
E4352,93,59,96,70,45,363,3797
E8460,97,48,85,59,74,363,3798
E2050,93,91,72,64,43,363,3799
E0665,84,50,98,54,77,363,3800
E8345,45,52,98,99,69,363,3801
E2535,55,76,62,84,86,363,3802
E4195,78,98,69,47,71,363,3803
E1865,65,55,81,94,68,363,3804
E8925,100,80,48,40,95,363,3805
E2244,87,60,85,50,81,363,3806
E5711,80,84,64,57,78,363,3807
E8720,94,55,96,58,60,363,3808
E9911,92,57,80,85,49,363,3809
E1177,57,83,70,58,95,363,3810
E4425,60,65,56,91,91,363,3811
E1333,98,69,65,52,79,363,3812
E6900,86,40,77,60,100,363,3813
E2463,79,80,81,70,53,363,3814
E7939,56,61,98,60,88,363,3815
E5173,94,92,43,80,54,363,3816
E1432,86,69,83,48,77,363,3817
E2970,86,50,82,93,52,363,3818
E1816,94,54,62,93,60,363,3819
E7253,47,97,93,81,45,363,3820
E1989,75,85,73,68,62,363,3821
E8846,64,91,96,68,44,363,3822
E2071,40,69,98,66,90,363,3823
E3055,82,86,58,75,62,363,3824
E0021,49,73,79,91,71,363,3825
E3640,57,85,68,69,84,363,3826
E9707,64,73,83,89,54,363,3827
E0529,42,43,87,99,92,363,3828
E5688,49,90,59,65,100,363,3829
E8195,97,56,91,70,49,363,3830
E2790,43,58,87,86,89,363,3831
E9457,79,44,40,99,100,362,3832
E5954,52,87,79,70,74,362,3833
E4965,69,75,91,57,70,362,3834
E1309,86,85,40,95,56,362,3835
E0704,60,68,98,95,41,362,3836
E9725,89,85,43,64,81,362,3837
E6061,81,88,54,87,52,362,3838
E0259,75,70,81,83,53,362,3839
E2591,94,45,100,51,72,362,3840
E3628,60,46,73,86,97,362,3841
E8320,43,79,68,78,94,362,3842
E4101,86,70,77,60,69,362,3843
E9793,91,54,76,83,58,362,3844
E3573,53,82,61,74,92,362,3845
E4570,63,90,50,77,82,362,3846
E1726,83,91,65,63,60,362,3847
E8100,85,77,51,53,96,362,3848
E4429,41,72,98,92,59,362,3849
E5540,68,82,63,66,83,362,3850
E8905,88,52,99,65,58,362,3851
E3089,84,43,97,66,72,362,3852
E0358,78,82,99,42,61,362,3853
E9726,42,100,52,81,87,362,3854
E5295,81,68,92,46,75,362,3855
E0271,50,98,65,88,61,362,3856
E6327,57,90,43,85,87,362,3857
E0929,88,58,78,55,83,362,3858
E9287,67,97,99,49,50,362,3859
E4765,83,74,76,89,40,362,3860
E1520,77,60,74,98,53,362,3861
E2470,58,90,63,79,72,362,3862
E1235,63,87,59,84,69,362,3863
E7405,71,64,51,84,92,362,3864
E3314,93,81,92,56,40,362,3865
E5247,58,70,52,100,82,362,3866
E3562,79,52,71,66,94,362,3867
E1514,70,83,97,49,63,362,3868
E5096,52,70,80,98,62,362,3869
E5302,79,88,76,76,43,362,3870
E6790,72,57,48,94,91,362,3871
E4123,98,77,94,42,51,362,3872
E2679,67,99,65,82,49,362,3873
E0884,66,52,95,69,80,362,3874
E6534,74,82,48,66,92,362,3875
E5282,66,85,99,47,65,362,3876
E5225,100,66,48,79,69,362,3877
E8912,96,93,54,73,46,362,3878
E3079,99,65,67,60,71,362,3879
E7192,97,63,74,49,79,362,3880
E0449,64,85,59,95,59,362,3881
E0636,48,92,86,49,87,362,3882
E5366,93,65,77,44,83,362,3883
E7242,75,63,83,65,76,362,3884
E8332,75,87,76,47,77,362,3885
E4018,88,71,46,60,97,362,3886
E1546,96,61,83,66,56,362,3887
E3816,81,51,83,59,88,362,3888
E5478,55,68,97,89,53,362,3889
E8697,72,43,87,77,83,362,3890
E7687,54,66,95,93,54,362,3891
E4247,89,66,53,60,94,362,3892
E1738,80,96,70,58,58,362,3893
E7027,75,96,62,51,78,362,3894
E2158,77,53,96,87,49,362,3895
E8430,92,54,64,97,55,362,3896
E0816,49,63,77,77,96,362,3897
E0074,89,91,45,81,56,362,3898
E0360,42,86,57,81,96,362,3899
E6596,84,99,54,84,41,362,3900
E8960,69,42,82,88,81,362,3901
E0626,97,83,48,42,92,362,3902
E0750,63,48,92,76,83,362,3903
E8794,60,74,60,69,99,362,3904
E3338,72,72,74,71,73,362,3905
E2934,41,86,91,49,95,362,3906
E1906,87,100,53,81,41,362,3907
E8417,42,59,89,88,84,362,3908
E0541,89,70,95,47,61,362,3909
E4539,91,84,64,46,77,362,3910
E8274,79,53,90,74,66,362,3911
E4861,44,92,46,82,98,362,3912
E8605,54,60,85,80,83,362,3913
E4956,59,87,41,85,90,362,3914
E2897,96,83,48,42,93,362,3915
E5343,48,92,97,49,76,362,3916
E4290,53,48,90,97,74,362,3917
E3812,82,100,43,87,50,362,3918
E9325,93,63,77,50,79,362,3919
E1306,47,95,98,52,70,362,3920
E2872,90,68,74,59,71,362,3921
E0652,82,94,71,71,44,362,3922
E1845,95,74,66,62,64,361,3923
E0326,52,58,85,72,94,361,3924
E2211,86,53,65,93,64,361,3925
E2186,63,91,57,98,52,361,3926
E3317,72,58,97,45,89,361,3927
E0684,89,79,62,67,64,361,3928
E0946,77,45,68,85,86,361,3929
E1851,50,54,100,62,95,361,3930
E7928,59,80,96,64,62,361,3931
E6744,47,96,69,76,73,361,3932
E8568,51,76,69,74,91,361,3933
E9113,76,66,97,59,63,361,3934
E2908,55,65,77,80,84,361,3935
E5421,53,67,51,94,96,361,3936
E5005,59,97,81,59,65,361,3937
E4192,80,65,90,54,72,361,3938
E4778,71,53,44,100,93,361,3939
E2644,86,80,79,60,56,361,3940
E9952,50,85,82,80,64,361,3941
E0581,77,90,46,66,82,361,3942
E7714,97,98,48,48,70,361,3943
E2307,66,60,81,100,54,361,3944
E7006,77,92,48,73,71,361,3945
E1097,67,92,41,69,92,361,3946
E2830,97,73,40,78,73,361,3947
E1991,56,73,98,45,89,361,3948
E1513,75,63,75,65,83,361,3949
E8899,41,47,91,93,89,361,3950
E2988,96,96,56,58,55,361,3951
E5162,73,60,91,42,95,361,3952
E3457,95,57,68,55,86,361,3953
E6599,88,97,51,83,42,361,3954
E7256,82,43,81,60,95,361,3955
E6169,53,58,80,80,90,361,3956
E3376,67,94,52,85,63,361,3957
E9358,88,79,50,46,98,361,3958
E5030,86,88,49,40,98,361,3959
E7333,69,78,82,70,62,361,3960
E5254,98,58,89,60,56,361,3961
E6754,63,72,100,54,72,361,3962
E0594,81,56,64,69,91,361,3963
E1814,48,98,91,45,79,361,3964
E6625,74,80,59,72,76,361,3965
E8677,48,73,78,71,91,361,3966
E1144,78,71,94,69,49,361,3967
E1927,77,78,80,47,79,361,3968
E6959,80,80,85,42,74,361,3969
E0931,90,75,50,46,100,361,3970
E8037,93,79,48,58,83,361,3971
E7326,87,84,60,44,86,361,3972
E6536,67,61,95,58,80,361,3973
E3591,79,85,56,95,46,361,3974
E2851,50,100,65,89,57,361,3975
E0808,81,81,71,80,48,361,3976
E9404,90,43,48,95,85,361,3977
E5974,64,48,73,92,84,361,3978
E4304,65,68,100,55,73,361,3979
E9498,49,86,93,86,47,361,3980
E5418,98,54,72,66,71,361,3981
E9169,73,76,92,77,43,361,3982
E5970,87,79,64,78,53,361,3983
E6689,52,63,77,87,82,361,3984
E4108,87,87,45,59,83,361,3985
E1497,49,79,68,67,98,361,3986
E4749,85,75,65,54,82,361,3987
E5968,74,97,77,72,41,361,3988
E1819,86,50,76,97,52,361,3989
E6256,51,72,76,88,74,361,3990
E8284,81,90,50,73,67,361,3991
E1688,86,92,98,40,45,361,3992
E2210,93,73,70,49,76,361,3993
E0431,79,63,85,77,57,361,3994
E6935,86,69,68,72,66,361,3995
E7753,68,87,73,60,73,361,3996
E2868,56,60,94,93,58,361,3997
E7125,87,73,87,69,45,361,3998
E7538,72,83,59,65,81,360,3999
E0467,98,53,44,77,88,360,4000
E6879,90,92,80,54,44,360,4001
E6310,40,80,81,80,79,360,4002
E5523,55,99,82,78,46,360,4003
E8531,73,66,56,68,97,360,4004
E0737,67,68,75,69,81,360,4005
E6758,63,72,72,97,56,360,4006
E3270,78,53,95,48,86,360,4007
E3135,76,100,71,57,56,360,4008
E5129,51,99,56,61,93,360,4009
E2786,73,54,98,65,70,360,4010
E8556,70,83,79,70,58,360,4011
E4530,81,65,75,88,51,360,4012
E7787,86,63,82,57,72,360,4013
E6476,85,99,54,65,57,360,4014
E7558,56,54,73,93,84,360,4015
E9576,47,87,66,87,73,360,4016
E5218,72,89,41,67,91,360,4017
E3955,64,93,65,42,96,360,4018
E2538,68,79,97,43,73,360,4019
E8050,69,42,73,78,98,360,4020
E5585,70,53,83,70,84,360,4021
E2297,97,52,81,55,75,360,4022
E7478,54,59,72,89,86,360,4023
E5525,79,88,65,77,51,360,4024
E2958,56,77,88,59,80,360,4025
E5993,93,83,50,46,88,360,4026
E8095,47,54,98,93,68,360,4027
E0687,79,89,64,82,46,360,4028
E4962,71,71,89,83,46,360,4029
E2228,98,69,67,60,66,360,4030
E7001,40,77,83,65,95,360,4031
E7154,43,65,84,75,93,360,4032
E3977,82,49,43,95,91,360,4033
E2006,89,70,67,70,64,360,4034
E9831,62,61,91,60,86,360,4035
E0697,68,58,59,93,82,360,4036
E1112,68,52,94,51,95,360,4037
E5052,58,97,42,88,75,360,4038
E9630,75,88,62,93,42,360,4039
E1126,79,48,68,92,73,360,4040
E0559,82,71,54,83,70,360,4041
E3040,46,60,94,91,69,360,4042
E9302,92,86,41,42,99,360,4043
E2446,73,84,80,82,41,360,4044
E2322,87,82,43,79,69,360,4045
E9064,97,45,100,57,61,360,4046
E3887,88,56,51,88,77,360,4047
E9776,69,90,58,45,98,360,4048
E5192,59,84,95,66,56,360,4049
E0422,48,86,90,77,59,360,4050
E5534,59,47,81,100,73,360,4051
E5285,42,81,86,54,97,360,4052
E5367,55,61,91,75,78,360,4053
E0790,55,100,75,46,84,360,4054
E5505,64,87,56,82,71,360,4055
E6203,73,85,72,53,77,360,4056
E3718,51,71,67,100,71,360,4057
E8610,71,68,86,72,63,360,4058
E4911,99,61,55,45,100,360,4059
E9399,59,99,74,57,71,360,4060
E8764,45,55,97,92,71,360,4061
E1191,97,78,56,86,43,360,4062
E8502,68,46,75,83,88,360,4063
E0641,78,64,83,77,58,360,4064
E2359,61,86,74,97,42,360,4065
E6236,59,97,64,82,58,360,4066
E3240,75,82,76,83,44,360,4067
E5579,83,55,69,89,64,360,4068
E3347,99,59,54,83,65,360,4069
E7496,99,65,60,82,54,360,4070
E8731,70,79,68,95,48,360,4071
E9551,68,59,82,75,76,360,4072
E5908,75,73,83,45,84,360,4073
E6492,40,93,42,92,93,360,4074
E0547,44,85,86,89,56,360,4075
E2607,77,55,93,64,71,360,4076
E1332,77,66,55,85,77,360,4077
E9534,62,76,97,79,46,360,4078
E0254,92,49,63,57,99,360,4079
E7058,97,70,64,57,72,360,4080
E1022,86,80,43,56,95,360,4081
E0785,73,68,57,69,93,360,4082
E3013,56,86,64,91,63,360,4083
E7920,56,89,97,75,43,360,4084
E1935,80,96,43,43,98,360,4085
E3329,41,96,91,91,41,360,4086
E9542,43,72,73,86,86,360,4087
E0497,82,81,54,87,56,360,4088
E5550,55,85,55,67,98,360,4089
E4155,91,91,52,70,56,360,4090
E0690,83,96,73,68,40,360,4091
E3981,86,52,86,43,93,360,4092
E4514,97,50,79,58,76,360,4093
E4927,60,59,62,90,89,360,4094
E4679,42,70,85,86,77,360,4095
E3305,63,77,68,71,81,360,4096
E1671,93,84,77,41,65,360,4097
E9988,64,88,83,43,81,359,4098
E0921,55,96,88,54,66,359,4099
E2043,93,48,86,88,44,359,4100
E5086,44,96,45,76,98,359,4101
E9829,81,76,58,80,64,359,4102
E2331,50,100,42,81,86,359,4103
E5522,50,87,97,84,41,359,4104
E8753,77,81,93,45,63,359,4105
E4789,54,70,83,71,81,359,4106
E1674,61,85,55,81,77,359,4107
E4606,55,73,41,100,90,359,4108
E0838,93,76,66,51,73,359,4109
E4839,78,70,84,43,84,359,4110
E5890,50,60,91,76,82,359,4111
E8212,42,92,53,81,91,359,4112
E9334,98,58,95,40,68,359,4113
E6698,60,97,91,47,64,359,4114
E3841,87,99,73,45,55,359,4115
E2795,94,58,42,87,78,359,4116
E8930,53,75,46,90,95,359,4117
E2952,92,78,46,90,53,359,4118
E7880,54,58,97,61,89,359,4119
E5381,73,59,75,91,61,359,4120
E0249,47,49,95,90,78,359,4121
E4041,98,40,77,53,91,359,4122
E6939,47,59,80,83,90,359,4123
E2038,46,78,67,91,77,359,4124
E4935,50,42,100,84,83,359,4125
E2354,65,73,47,89,85,359,4126
E6399,90,79,86,43,61,359,4127
E6234,61,88,69,79,62,359,4128
E0165,54,84,70,82,69,359,4129
E8069,99,41,94,64,61,359,4130
E0888,41,78,56,88,96,359,4131
E7802,47,60,99,65,88,359,4132
E7927,61,52,76,100,70,359,4133
E2159,83,97,51,54,74,359,4134
E2303,86,72,95,42,64,359,4135
E7567,43,45,99,75,97,359,4136
E5609,100,75,80,50,54,359,4137
E2955,69,82,66,79,63,359,4138
E2418,45,85,53,99,77,359,4139
E6852,96,76,91,47,49,359,4140
E7822,64,44,91,70,90,359,4141
E1744,94,74,53,76,62,359,4142
E1267,70,58,94,80,57,359,4143
E8144,53,89,88,60,69,359,4144
E9424,95,100,57,59,48,359,4145
E4224,86,72,99,46,56,359,4146
E7287,66,63,81,75,74,359,4147
E5408,87,83,57,67,65,359,4148
E3090,89,87,50,47,86,359,4149
E4595,74,61,98,81,45,359,4150
E2946,45,88,85,62,79,359,4151
E1442,41,61,81,100,76,359,4152
E4144,77,63,95,41,83,359,4153
E3125,82,100,49,62,66,359,4154
E3546,99,58,62,45,95,359,4155
E0531,87,48,92,82,50,359,4156
E5419,45,80,99,92,43,359,4157
E3482,85,75,57,83,59,359,4158
E0733,65,83,72,44,95,359,4159
E3365,81,62,90,47,79,359,4160
E2409,93,64,86,76,40,359,4161
E6296,79,40,89,81,70,359,4162
E5643,73,84,99,42,61,359,4163
E3230,50,90,100,57,62,359,4164
E5298,70,73,76,80,60,359,4165
E4926,87,65,41,89,77,359,4166
E6268,50,75,71,88,75,359,4167
E8171,71,85,81,45,77,359,4168
E6661,64,66,59,71,99,359,4169
E1243,96,94,41,77,51,359,4170
E0195,56,43,76,90,94,359,4171
E5097,87,45,84,53,90,359,4172
E5558,85,60,40,98,76,359,4173
E0948,67,81,52,59,100,359,4174
E4534,84,64,44,91,76,359,4175
E6443,44,100,45,76,94,359,4176
E1992,42,97,84,41,95,359,4177
E2518,92,70,46,92,59,359,4178
E4901,79,48,63,83,86,359,4179
E2697,95,55,99,63,47,359,4180
E9158,72,77,82,46,82,359,4181
E5948,77,46,50,88,98,359,4182
E9666,75,76,69,89,50,359,4183
E0375,63,60,95,81,60,359,4184
E9736,59,89,83,48,79,358,4185
E5059,95,85,64,48,66,358,4186
E2438,77,55,87,82,57,358,4187
E3711,71,55,68,72,92,358,4188
E0120,99,40,92,41,86,358,4189
E6553,42,91,68,71,86,358,4190
E1664,81,55,95,59,68,358,4191
E8810,63,93,78,44,80,358,4192
E3215,76,77,83,67,55,358,4193
E8495,67,61,68,93,69,358,4194
E3453,82,67,76,84,49,358,4195
E6572,61,91,67,45,94,358,4196
E9675,65,73,91,83,46,358,4197
E4829,89,54,69,92,54,358,4198
E7223,49,76,76,70,87,358,4199
E0567,91,45,81,100,41,358,4200
E6710,63,82,40,93,80,358,4201
E9846,54,95,98,44,67,358,4202
E7796,67,50,51,99,91,358,4203
E4550,72,100,48,59,79,358,4204
E2933,77,71,92,66,52,358,4205
E8875,54,66,87,63,88,358,4206
E2184,98,71,46,91,52,358,4207
E4880,79,71,73,84,51,358,4208
E3790,55,98,43,84,78,358,4209
E6685,98,98,53,44,65,358,4210
E7364,78,91,42,85,62,358,4211
E5577,61,52,94,66,85,358,4212
E7298,58,99,82,52,67,358,4213
E2901,92,55,47,76,88,358,4214
E9795,63,71,74,67,83,358,4215
E5151,83,40,78,57,100,358,4216
E6577,88,67,93,55,55,358,4217
E4948,89,69,92,54,54,358,4218
E1661,85,64,96,73,40,358,4219
E5054,75,91,65,46,81,358,4220
E0184,54,52,87,76,89,358,4221
E4081,73,83,70,63,69,358,4222
E3906,56,68,92,62,80,358,4223
E9366,40,89,73,64,92,358,4224
E6217,51,89,74,79,65,358,4225
E1297,77,94,45,90,52,358,4226
E9871,83,78,49,76,72,358,4227
E8854,64,69,93,77,55,358,4228
E6512,52,81,62,94,69,358,4229
E7705,48,70,66,95,79,358,4230
E1275,86,77,55,42,98,358,4231
E5186,48,82,80,54,94,358,4232
E2276,80,82,55,68,73,358,4233
E8765,86,44,94,68,66,358,4234
E7107,53,95,92,62,56,358,4235
E4222,96,49,57,67,89,358,4236
E0600,41,73,86,91,67,358,4237
E5042,44,84,65,80,85,358,4238
E1831,49,98,61,84,66,358,4239
E4975,50,64,81,77,86,358,4240
E9344,96,67,78,48,69,358,4241
E4097,71,79,51,80,77,358,4242
E6464,54,43,89,89,83,358,4243
E5243,73,81,82,69,53,358,4244
E0833,54,86,71,78,69,358,4245
E8277,90,85,63,76,44,358,4246
E4954,97,76,42,47,96,358,4247
E1443,85,92,75,65,41,358,4248
E2703,94,66,68,59,71,358,4249
E5193,92,69,63,40,94,358,4250
E8405,63,74,95,70,56,358,4251
E4779,66,83,66,98,45,358,4252
E3583,52,42,84,83,97,358,4253
E3107,90,42,96,90,40,358,4254
E3345,70,94,50,91,53,358,4255
E2540,46,69,80,70,93,358,4256
E7320,55,67,98,43,95,358,4257
E3205,87,57,58,61,95,358,4258
E1246,55,79,64,64,96,358,4259
E4298,83,51,88,53,83,358,4260
E2339,59,94,73,74,58,358,4261
E7029,93,41,59,92,73,358,4262
E5109,82,41,88,54,93,358,4263
E7954,96,89,41,41,91,358,4264
E8654,87,51,77,73,70,358,4265
E2690,77,78,40,73,90,358,4266
E8492,64,61,64,90,79,358,4267
E2194,84,49,76,89,60,358,4268
E8879,45,94,96,80,43,358,4269
E5766,99,96,67,45,51,358,4270
E3617,60,55,70,84,89,358,4271
E1988,49,43,96,96,74,358,4272
E8350,62,40,78,86,92,358,4273
E3474,89,87,42,99,41,358,4274
E7387,57,86,50,72,93,358,4275
E0906,44,78,98,93,45,358,4276
E3350,80,67,100,62,49,358,4277
E0765,46,79,80,86,67,358,4278
E0625,87,73,87,54,57,358,4279
E3806,91,50,65,54,98,358,4280
E6354,98,63,84,57,56,358,4281
E8532,71,70,67,77,73,358,4282
E9203,41,93,51,80,93,358,4283
E7952,99,88,47,48,76,358,4284
E9685,95,63,65,88,47,358,4285
E6557,67,94,55,66,76,358,4286
E5406,66,85,85,81,41,358,4287
E4933,47,96,46,73,96,358,4288
E4817,61,75,72,63,87,358,4289
E4277,55,76,77,97,52,357,4290
E3814,40,59,85,81,92,357,4291
E6973,84,81,79,61,52,357,4292
E4591,50,78,88,87,54,357,4293
E9970,95,91,53,59,59,357,4294
E9279,98,53,50,77,79,357,4295
E7654,44,93,47,87,86,357,4296
E3875,63,99,99,40,56,357,4297
E5858,99,45,80,41,92,357,4298
E8860,89,54,62,89,63,357,4299
E3092,50,69,59,92,87,357,4300
E3763,80,68,55,72,82,357,4301
E9872,81,88,45,97,46,357,4302
E1138,72,60,57,100,68,357,4303
E6638,83,65,76,79,54,357,4304
E5131,76,83,90,55,53,357,4305
E9915,90,91,44,63,69,357,4306
E5635,95,65,67,78,52,357,4307
E5226,53,91,99,55,59,357,4308
E9727,85,52,61,87,72,357,4309
E5731,76,44,85,88,64,357,4310
E6969,79,64,56,59,99,357,4311
E8255,98,73,67,66,53,357,4312
E9119,96,53,77,46,85,357,4313
E1699,64,90,75,79,49,357,4314
E6732,73,62,81,98,43,357,4315
E8104,64,76,56,82,79,357,4316
E4972,67,89,71,49,81,357,4317
E0270,78,44,92,70,73,357,4318
E8900,81,89,59,76,52,357,4319
E6866,40,69,68,81,99,357,4320
E1523,84,75,92,55,51,357,4321
E1557,75,84,66,54,78,357,4322
E4276,82,49,74,95,57,357,4323
E7524,64,58,49,90,96,357,4324
E5470,86,99,54,71,47,357,4325
E6520,64,99,62,65,67,357,4326
E8952,72,62,63,69,91,357,4327
E4910,51,92,58,97,59,357,4328
E5721,82,44,43,88,100,357,4329
E2188,89,81,47,55,85,357,4330
E2034,80,41,85,87,64,357,4331
E9018,79,72,62,93,51,357,4332
E4957,100,81,41,48,87,357,4333
E8173,46,97,67,56,91,357,4334
E8985,99,48,67,91,52,357,4335
E5050,99,65,48,79,66,357,4336
E0429,41,61,99,89,67,357,4337
E6404,94,69,40,99,55,357,4338
E4825,79,94,43,94,47,357,4339
E7611,90,80,52,77,58,357,4340
E8112,98,54,78,79,48,357,4341
E0515,48,88,85,79,57,357,4342
E2128,54,58,60,87,98,357,4343
E9263,57,92,75,48,85,357,4344
E7103,68,97,64,66,62,357,4345
E4107,67,47,70,94,79,357,4346
E6546,61,60,88,98,50,357,4347
E1884,74,46,96,82,59,357,4348
E0856,54,81,69,83,70,357,4349
E2820,81,74,62,63,77,357,4350
E7760,68,93,68,50,78,357,4351
E2296,59,100,53,92,53,357,4352
E7990,79,74,55,60,89,357,4353
E7638,100,71,79,53,54,357,4354
E6362,61,46,82,98,70,357,4355
E3153,87,61,57,98,54,357,4356
E3557,81,64,79,74,59,357,4357
E0662,62,84,78,64,69,357,4358
E7726,81,77,48,77,74,357,4359
E6265,69,62,87,74,65,357,4360
E9241,70,96,55,49,87,357,4361
E4603,51,68,99,76,63,357,4362
E5941,55,74,70,59,99,357,4363
E2356,61,56,70,94,76,357,4364
E0185,63,78,69,53,94,357,4365
E1070,57,81,50,69,100,357,4366
E3220,70,55,67,85,80,357,4367
E8125,94,53,77,82,51,357,4368
E2003,78,83,51,93,52,357,4369
E7015,68,86,67,85,51,357,4370
E8629,61,82,54,98,62,357,4371
E7936,61,81,97,70,48,357,4372
E2676,42,78,50,97,90,357,4373
E6700,55,98,96,55,53,357,4374
E3236,87,100,77,49,44,357,4375
E5400,87,87,52,48,83,357,4376
E2932,55,73,79,52,98,357,4377
E4083,42,97,88,83,47,357,4378
E0871,88,52,57,87,73,357,4379
E2812,48,78,84,62,85,357,4380
E6036,71,62,81,52,90,356,4381
E6932,85,42,43,91,95,356,4382
E6394,79,43,67,99,68,356,4383
E3572,46,78,82,63,87,356,4384
E9401,46,67,50,93,100,356,4385
E7349,86,92,72,53,53,356,4386
E1449,92,85,88,50,41,356,4387
E0604,67,89,73,64,63,356,4388
E8111,83,67,52,75,79,356,4389
E7853,88,82,46,84,56,356,4390
E6558,57,59,81,71,88,356,4391
E9681,52,75,81,76,72,356,4392
E8967,50,87,49,87,83,356,4393
E1764,41,80,94,85,56,356,4394
E4930,82,76,42,70,86,356,4395
E5750,51,85,97,79,44,356,4396
E8491,87,52,85,69,63,356,4397
E7545,67,50,85,58,96,356,4398
E4494,60,81,50,71,94,356,4399
E6220,65,95,63,62,71,356,4400
E3792,42,64,85,82,83,356,4401
E2467,85,86,99,40,46,356,4402
E0338,74,85,60,70,67,356,4403
E0406,72,73,89,66,56,356,4404
E8331,99,89,48,49,71,356,4405
E4533,85,44,85,70,72,356,4406
E3184,77,41,42,96,100,356,4407
E8113,74,54,95,86,47,356,4408
E7227,67,94,62,78,55,356,4409
E0728,77,89,57,60,73,356,4410
E7951,56,57,99,84,60,356,4411
E1644,87,91,63,68,47,356,4412
E9678,43,91,44,97,81,356,4413
E8504,77,59,44,83,93,356,4414
E8621,40,92,94,49,81,356,4415
E1568,42,49,100,77,88,356,4416
E9553,44,95,76,83,58,356,4417
E1127,99,58,89,45,65,356,4418
E5260,81,100,45,85,45,356,4419
E9528,51,82,90,86,47,356,4420
E5732,73,80,46,81,76,356,4421
E2621,93,63,86,42,72,356,4422
E7509,56,66,97,61,76,356,4423
E2212,76,81,60,43,96,356,4424
E8145,100,87,40,46,83,356,4425
E1891,74,67,79,96,40,356,4426
E0123,100,44,84,41,87,356,4427
E0408,73,45,95,100,43,356,4428
E8063,77,86,52,71,70,356,4429
E2640,90,72,42,87,65,356,4430
E7473,67,51,48,91,99,356,4431
E1447,82,96,44,73,61,356,4432
E1361,57,61,69,98,71,356,4433
E2839,75,54,67,96,64,356,4434
E2905,76,60,81,85,54,356,4435
E4777,90,57,77,56,76,356,4436
E2865,87,80,98,44,47,356,4437
E4710,70,68,92,76,50,356,4438
E3496,86,62,94,51,63,356,4439
E1752,66,98,98,44,50,356,4440
E4895,71,47,66,74,98,356,4441
E6052,90,42,64,81,79,356,4442
E6426,76,52,87,95,46,356,4443
E5060,68,71,76,94,47,356,4444
E0492,56,74,76,80,70,356,4445
E6856,100,79,41,54,82,356,4446
E7875,43,81,76,83,73,356,4447
E5742,97,65,56,47,91,356,4448
E7114,94,80,71,52,59,356,4449
E5340,97,44,73,82,60,356,4450
E5677,63,48,65,83,97,356,4451
E5159,73,46,87,62,88,356,4452
E8496,94,41,75,61,85,356,4453
E2308,98,61,43,59,95,356,4454
E4579,55,63,90,57,91,356,4455
E4724,64,74,67,100,51,356,4456
E7476,51,55,89,83,78,356,4457
E1158,56,95,51,81,73,356,4458
E8452,78,90,46,46,96,356,4459
E0751,93,74,75,68,46,356,4460
E0776,85,72,73,66,60,356,4461
E2239,73,47,73,93,70,356,4462
E2248,87,66,51,53,99,356,4463
E6428,55,87,61,61,92,356,4464
E4266,90,50,87,52,77,356,4465
E8465,95,43,96,49,73,356,4466
E7429,49,69,80,98,60,356,4467
E4234,74,94,80,54,54,356,4468
E4238,82,48,81,79,66,356,4469
E1617,63,57,76,90,70,356,4470
E9150,75,78,54,88,61,356,4471
E2405,90,50,84,42,90,356,4472
E6878,60,97,57,88,54,356,4473
E9786,84,83,55,60,74,356,4474
E9834,60,57,100,92,47,356,4475
E1223,68,98,60,46,84,356,4476
E8890,66,96,71,60,63,356,4477
E2639,91,89,62,48,66,356,4478
E1946,42,93,64,72,85,356,4479
E4050,56,94,61,83,61,355,4480
E7271,94,92,48,62,59,355,4481
E5781,71,61,83,72,68,355,4482
E3274,74,94,69,49,69,355,4483
E3877,82,75,42,94,62,355,4484
E4010,95,61,57,85,57,355,4485
E6274,71,92,62,45,85,355,4486
E9357,84,60,78,89,44,355,4487
E3243,85,51,56,78,85,355,4488
E7231,46,94,63,100,52,355,4489
E6177,51,72,45,95,92,355,4490
E7782,82,75,71,71,56,355,4491
E4135,98,88,57,49,63,355,4492
E1440,80,69,44,64,98,355,4493
E7700,49,90,67,96,53,355,4494
E2399,71,57,98,84,45,355,4495
E7433,81,86,80,52,56,355,4496
E1385,77,49,99,73,57,355,4497
E2064,47,71,74,89,74,355,4498
E2733,89,52,55,70,89,355,4499
E4593,61,46,77,98,73,355,4500
E2363,70,63,72,72,78,355,4501
E6803,48,85,73,83,66,355,4502
E7449,67,55,75,85,73,355,4503
E7780,46,89,84,47,89,355,4504
E5754,60,71,74,56,94,355,4505
E4282,61,90,55,77,72,355,4506
E3738,73,59,59,83,81,355,4507
E6965,95,65,55,78,62,355,4508
E4503,94,51,94,75,41,355,4509
E7078,87,76,94,48,50,355,4510
E7616,43,91,92,57,72,355,4511
E2749,94,73,63,81,44,355,4512
E9142,94,57,47,61,96,355,4513
E4656,74,62,67,90,62,355,4514
E1351,50,68,56,100,81,355,4515
E7841,81,77,59,80,58,355,4516
E4055,69,68,49,71,98,355,4517
E0433,57,79,45,86,88,355,4518
E7212,98,85,46,60,66,355,4519
E3784,67,64,44,95,85,355,4520
E6031,73,52,89,78,63,355,4521
E8751,84,46,76,80,69,355,4522
E4153,63,42,97,67,86,355,4523
E8526,86,60,74,52,83,355,4524
E5976,87,51,82,73,62,355,4525
E0592,74,64,69,100,48,355,4526
E6444,85,61,67,100,42,355,4527
E5420,54,45,98,82,76,355,4528
E5862,55,61,92,63,84,355,4529
E9093,74,93,48,93,47,355,4530
E1189,46,88,66,72,83,355,4531
E5474,56,84,96,50,69,355,4532
E4781,78,92,85,48,52,355,4533
E1525,79,48,89,56,83,355,4534
E0272,63,97,41,63,91,355,4535
E1211,69,89,80,50,67,355,4536
E8870,93,48,72,73,69,355,4537
E7494,83,75,54,55,88,355,4538
E3060,49,94,61,64,87,355,4539
E4126,76,67,51,75,86,355,4540
E9605,94,64,63,74,60,355,4541
E9578,69,45,90,54,97,355,4542
E9804,91,54,86,64,60,355,4543
E1242,48,89,93,82,43,355,4544
E4819,58,58,93,48,98,355,4545
E4440,63,69,52,81,90,355,4546
E1409,75,91,82,48,59,355,4547
E4542,84,65,82,76,48,355,4548
E6655,69,46,70,76,94,355,4549
E4361,56,60,86,76,77,355,4550
E7055,40,70,68,79,98,355,4551
E5727,82,72,49,64,88,355,4552
E7481,57,72,49,84,93,355,4553
E6855,89,55,69,82,60,355,4554
E6174,43,52,99,63,98,355,4555
E7122,58,97,88,51,61,355,4556
E6104,87,84,76,42,66,355,4557
E7681,66,90,58,63,78,355,4558
E0011,44,83,88,49,91,355,4559
E8153,63,46,90,75,81,355,4560
E6915,73,100,64,67,51,355,4561
E5160,62,59,61,79,94,355,4562
E3057,84,87,60,78,46,355,4563
E9159,73,77,54,94,57,355,4564
E9312,70,54,67,91,73,355,4565
E6371,81,54,70,80,69,354,4566
E0196,67,51,86,95,55,354,4567
E3741,90,45,63,97,59,354,4568
E0099,98,79,54,51,72,354,4569
E3282,81,77,72,44,80,354,4570
E3958,92,90,45,74,53,354,4571
E1555,93,65,83,47,66,354,4572
E4039,79,63,67,90,55,354,4573
E7900,42,64,91,79,78,354,4574
E0607,78,85,54,83,54,354,4575
E7698,75,42,45,92,100,354,4576
E6870,54,92,56,85,67,354,4577
E8898,100,57,54,76,67,354,4578
E2485,82,97,41,88,46,354,4579
E0439,92,86,60,46,70,354,4580
E5004,97,70,51,75,61,354,4581
E1231,79,66,65,93,51,354,4582
E5091,98,88,51,60,57,354,4583
E0634,41,79,72,83,79,354,4584
E0444,72,40,67,77,98,354,4585
E8636,87,66,59,88,54,354,4586
E2931,65,76,73,87,53,354,4587
E3612,68,40,100,97,49,354,4588
E7664,41,82,63,91,77,354,4589
E9138,78,78,50,58,90,354,4590
E3725,57,88,46,64,99,354,4591
E8326,48,99,57,52,98,354,4592
E9197,69,84,40,63,98,354,4593
E9087,55,81,70,90,58,354,4594
E0758,100,57,83,62,52,354,4595
E9085,83,46,56,100,69,354,4596
E4916,68,81,74,47,84,354,4597
E3544,62,80,74,97,41,354,4598
E5364,55,90,79,65,65,354,4599
E0263,60,63,45,87,99,354,4600
E8546,94,49,44,71,96,354,4601
E3652,65,57,57,91,84,354,4602
E3694,78,55,96,62,63,354,4603
E8038,53,66,70,98,67,354,4604
E6401,54,68,64,91,77,354,4605
E6592,66,92,53,88,55,354,4606
E8210,73,68,68,47,98,354,4607
E8135,54,66,55,99,80,354,4608
E4432,93,78,68,59,56,354,4609
E5548,57,87,64,78,68,354,4610
E8766,87,40,56,100,71,354,4611
E0546,45,94,79,61,75,354,4612
E8882,82,88,74,48,62,354,4613
E4833,47,75,41,94,97,354,4614
E1329,73,84,55,90,52,354,4615
E3448,96,93,67,56,42,354,4616
E8507,58,93,81,57,65,354,4617
E7374,47,59,94,89,65,354,4618
E6180,55,73,76,92,58,354,4619
E4527,65,64,98,60,67,354,4620
E7959,89,47,78,50,90,354,4621
E7064,61,65,79,97,52,354,4622
E6575,72,72,93,52,65,354,4623
E9348,62,91,97,53,51,354,4624
E6325,48,95,79,61,71,354,4625
E2132,67,95,57,85,50,354,4626
E8303,97,42,93,82,40,354,4627
E5650,63,73,68,91,59,354,4628
E5035,63,47,80,86,78,354,4629
E9390,100,94,61,49,50,354,4630
E5981,45,79,58,86,86,354,4631
E9649,83,42,78,84,67,354,4632
E8411,42,71,73,88,80,354,4633
E5738,49,76,93,58,78,354,4634
E7783,66,64,70,79,75,354,4635
E9236,100,67,85,40,62,354,4636
E2620,49,65,71,93,76,354,4637
E3459,100,40,80,44,90,354,4638
E3098,42,97,60,55,100,354,4639
E3097,47,78,66,97,66,354,4640
E2091,78,86,41,80,69,354,4641
E5912,43,95,48,84,84,354,4642
E0752,56,56,79,88,75,354,4643
E7908,64,90,78,71,51,354,4644
E6600,80,92,67,52,63,354,4645
E6788,75,87,85,54,53,354,4646
E2660,48,82,67,74,83,354,4647
E5681,67,57,95,44,91,354,4648
E7871,64,77,97,69,47,354,4649
E0385,48,100,43,83,80,354,4650
E9039,73,98,43,74,66,354,4651
E2288,84,50,83,62,75,354,4652
E0080,77,52,78,55,92,354,4653
E3191,56,68,74,95,61,354,4654
E4681,62,83,87,71,51,354,4655
E4690,83,77,77,71,46,354,4656
E6760,78,50,73,92,61,354,4657
E6630,60,56,82,77,79,354,4658
E4235,87,50,51,88,78,354,4659
E9738,83,65,82,84,40,354,4660
E5852,61,74,61,69,89,354,4661
E6877,80,83,43,66,82,354,4662
E3128,47,90,67,78,72,354,4663
E5953,63,99,71,47,74,354,4664
E2923,81,49,70,58,96,354,4665
E6176,48,94,93,75,44,354,4666
E6562,64,95,50,77,68,354,4667
E5154,71,64,91,47,81,354,4668
E4773,55,97,98,61,43,354,4669
E4576,46,95,44,96,72,353,4670
E2334,85,49,92,86,41,353,4671
E1349,92,53,80,73,55,353,4672
E4507,72,98,44,78,61,353,4673
E0817,96,48,99,65,45,353,4674
E3685,59,90,59,52,93,353,4675
E9127,74,58,84,72,65,353,4676
E1139,48,82,48,98,77,353,4677
E6653,99,58,70,85,41,353,4678
E8719,77,79,63,40,94,353,4679
E0347,76,64,59,94,60,353,4680
E5331,60,95,68,74,56,353,4681
E8473,47,82,48,95,81,353,4682
E3682,43,71,53,96,90,353,4683
E0038,82,62,85,69,55,353,4684
E2100,81,62,52,94,64,353,4685
E4038,94,55,90,57,57,353,4686
E0575,82,85,43,62,81,353,4687
E0646,50,87,97,70,49,353,4688
E9822,100,100,65,43,45,353,4689
E2768,67,93,59,54,80,353,4690
E5773,92,68,75,60,58,353,4691
E6439,55,93,67,89,49,353,4692
E4388,40,44,84,97,88,353,4693
E3611,53,80,70,78,72,353,4694
E5515,58,100,56,73,66,353,4695
E2683,68,66,79,90,50,353,4696
E2917,45,92,90,69,57,353,4697
E2010,47,62,98,48,98,353,4698
E4455,100,74,77,60,42,353,4699
E7557,90,42,43,89,89,353,4700
E3740,47,88,81,49,88,353,4701
E3913,61,72,60,68,92,353,4702
E9165,98,83,42,52,78,353,4703
E2246,47,93,62,72,79,353,4704
E4947,98,43,74,83,55,353,4705
E4966,58,77,89,71,58,353,4706
E9608,77,63,81,91,41,353,4707
E9767,56,79,56,95,67,353,4708
E1363,71,61,86,94,41,353,4709
E8909,52,77,72,53,99,353,4710
E8537,49,93,76,79,56,353,4711
E5533,72,83,56,75,67,353,4712
E1592,76,76,91,50,60,353,4713
E2809,43,56,91,65,98,353,4714
E3048,89,94,55,49,66,353,4715
E6812,55,63,51,96,88,353,4716
E0084,67,77,60,69,80,353,4717
E8243,54,62,84,69,84,353,4718
E9756,97,65,55,92,44,353,4719
E6124,80,62,96,56,59,353,4720
E2300,77,47,74,76,79,353,4721
E8301,91,57,58,83,64,353,4722
E9490,90,51,89,53,70,353,4723
E7807,97,60,42,87,67,353,4724
E6246,95,61,56,62,79,353,4725
E8833,82,82,60,78,51,353,4726
E6385,95,87,63,53,55,353,4727
E6786,44,65,67,91,86,353,4728
E8600,56,77,41,80,99,353,4729
E6526,77,58,77,83,58,353,4730
E4907,80,65,53,88,67,353,4731
E1843,40,55,80,81,97,353,4732
E6794,51,73,87,83,59,353,4733
E9766,64,98,49,61,81,353,4734
E3643,61,87,46,67,92,353,4735
E5023,63,58,84,62,86,353,4736
E9176,70,42,96,85,60,353,4737
E8944,76,75,61,54,87,353,4738
E4607,94,50,69,73,67,353,4739
E7286,84,62,55,63,89,353,4740
E9372,82,70,47,99,55,353,4741
E1094,87,87,63,59,57,353,4742
E6093,52,79,94,79,49,353,4743
E5429,92,90,41,55,75,353,4744
E4864,94,75,48,79,57,353,4745
E1050,59,53,70,91,80,353,4746
E6924,47,82,89,92,43,353,4747
E8973,71,88,51,64,79,353,4748
E5678,55,87,89,69,53,353,4749
E9865,87,48,98,54,66,353,4750
E0387,87,59,87,62,58,353,4751
E4411,91,67,76,53,66,353,4752
E0855,97,47,93,46,70,353,4753
E7399,95,70,58,54,76,353,4754
E5236,75,42,98,69,69,353,4755
E9199,94,69,56,56,78,353,4756
E4974,74,81,83,65,50,353,4757
E2152,95,88,65,47,58,353,4758
E5369,91,62,98,51,51,353,4759
E6764,63,57,78,100,55,353,4760
E4459,98,85,81,47,42,353,4761
E1253,59,61,91,63,79,353,4762
E6609,60,70,80,51,92,353,4763
E8457,56,85,74,51,87,353,4764
E8515,87,93,45,50,78,353,4765
E7403,45,94,56,68,90,353,4766
E0543,97,67,78,57,54,353,4767
E0774,77,48,93,66,69,353,4768
E4800,65,97,71,78,42,353,4769
E7539,75,96,51,53,78,353,4770
E5197,45,67,65,89,87,353,4771
E4673,52,85,85,65,66,353,4772
E2287,95,90,60,53,55,353,4773
E4867,58,99,47,97,52,353,4774
E3989,51,76,96,58,72,353,4775
E6747,50,100,75,54,74,353,4776
E3636,84,66,66,45,92,353,4777
E2617,76,48,88,100,41,353,4778
E4421,60,97,64,71,61,353,4779
E8480,82,43,56,90,81,352,4780
E2108,44,97,58,81,72,352,4781
E4212,79,87,91,50,45,352,4782
E6112,94,61,59,62,76,352,4783
E7673,72,91,57,47,85,352,4784
E4900,57,68,92,81,54,352,4785
E0383,81,89,54,80,48,352,4786
E7053,59,57,89,86,61,352,4787
E3489,99,63,75,63,52,352,4788
E0030,57,86,43,92,74,352,4789
E4567,85,45,64,92,66,352,4790
E1517,87,84,50,44,87,352,4791
E4112,48,84,75,85,60,352,4792
E3569,66,53,95,86,52,352,4793
E8894,66,49,97,70,70,352,4794
E6046,57,86,77,46,86,352,4795
E0474,76,77,93,48,58,352,4796
E1450,70,76,79,66,61,352,4797
E8805,92,52,58,74,76,352,4798
E5019,46,52,73,98,83,352,4799
E2196,48,93,65,84,62,352,4800
E1842,48,68,78,68,90,352,4801
E1694,76,61,81,54,80,352,4802
E0670,79,79,52,61,81,352,4803
E0275,75,93,49,41,94,352,4804
E4477,74,88,40,75,75,352,4805
E5276,76,44,90,57,85,352,4806
E0676,57,90,65,92,48,352,4807
E8867,43,98,73,71,67,352,4808
E1897,89,65,66,55,77,352,4809
E1258,59,87,82,59,65,352,4810
E4984,62,79,61,63,87,352,4811
E6937,42,66,80,92,72,352,4812
E1402,85,44,95,62,66,352,4813
E2523,61,84,57,84,66,352,4814
E5194,53,97,87,50,65,352,4815
E6906,91,73,73,41,74,352,4816
E4237,53,43,92,92,72,352,4817
E4472,100,57,56,78,61,352,4818
E9750,72,70,70,85,55,352,4819
E9071,44,89,77,99,43,352,4820
E0807,45,72,51,89,95,352,4821
E4918,45,85,49,79,94,352,4822
E8887,88,47,94,77,46,352,4823
E5014,61,68,65,63,95,352,4824
E2488,48,89,62,56,97,352,4825
E4004,42,75,57,83,95,352,4826
E0064,57,95,41,61,98,352,4827
E7865,87,86,42,76,61,352,4828
E3616,56,72,46,84,94,352,4829
E1837,50,62,81,96,63,352,4830
E8090,57,70,95,64,66,352,4831
E4473,66,51,69,80,86,352,4832
E9939,84,52,78,87,51,352,4833
E5682,44,58,82,100,68,352,4834
E2106,72,76,77,64,63,352,4835
E1093,75,59,51,95,72,352,4836
E9082,54,41,94,98,65,352,4837
E8937,54,80,61,66,91,352,4838
E2983,99,47,83,65,58,352,4839
E4742,45,93,45,98,71,352,4840
E6712,68,76,43,99,66,352,4841
E3322,48,95,75,56,78,352,4842
E4244,54,81,65,57,95,352,4843
E9634,45,99,70,68,70,352,4844
E2862,90,100,49,73,40,352,4845
E5569,96,51,72,92,41,352,4846
E4610,70,92,62,79,49,352,4847
E6714,99,41,70,64,78,352,4848
E0301,58,42,99,60,93,352,4849
E6149,69,77,67,52,87,352,4850
E7932,79,75,64,53,81,352,4851
E7188,49,60,96,80,67,352,4852
E2977,79,95,79,49,50,352,4853
E4863,77,87,45,48,95,352,4854
E7907,99,41,83,59,70,352,4855
E4300,49,96,62,98,47,352,4856
E0297,49,98,66,83,56,352,4857
E1925,45,77,58,95,77,352,4858
E7327,81,58,84,85,44,352,4859
E8128,71,47,98,60,76,352,4860
E6734,51,83,45,89,84,352,4861
E1202,62,89,73,68,60,352,4862
E9555,65,40,51,100,96,352,4863
E7788,51,65,81,69,86,352,4864
E1524,98,45,59,57,93,352,4865
E9964,64,98,50,62,78,352,4866
E1228,59,76,50,84,83,352,4867
E8234,64,94,61,73,60,352,4868
E2052,68,82,62,95,45,352,4869
E1583,67,100,42,85,58,352,4870
E7407,49,81,76,88,58,352,4871
E0147,78,51,79,72,72,352,4872
E6792,93,74,50,51,84,352,4873
E6430,52,78,51,99,72,352,4874
E9847,52,87,93,55,65,352,4875
E8756,58,53,66,79,96,352,4876
E7619,59,45,78,85,85,352,4877
E2455,59,70,47,80,96,352,4878
E5492,99,66,79,49,58,351,4879
E1260,78,59,68,92,54,351,4880
E6641,67,66,78,84,56,351,4881
E5125,48,67,65,99,72,351,4882
E5195,46,88,82,84,51,351,4883
E9427,74,95,69,41,72,351,4884
E7179,97,41,66,93,54,351,4885
E3533,96,56,47,55,97,351,4886
E1908,71,100,84,46,50,351,4887
E1656,92,48,82,50,79,351,4888
E8356,79,45,42,87,98,351,4889
E7555,71,85,67,52,76,351,4890
E3103,79,43,81,60,88,351,4891
E5277,46,77,64,85,79,351,4892
E4480,51,46,90,83,81,351,4893
E0229,98,91,48,59,55,351,4894
E7200,65,47,98,48,93,351,4895
E5899,94,94,66,48,49,351,4896
E6991,52,49,91,71,88,351,4897
E4504,80,70,83,57,61,351,4898
E9835,70,90,60,69,62,351,4899
E1188,56,91,73,48,83,351,4900
E1957,90,47,74,97,43,351,4901
E8953,91,80,60,60,60,351,4902
E7245,46,86,44,91,84,351,4903
E4008,74,78,99,51,49,351,4904
E7723,77,57,76,69,72,351,4905
E4230,64,48,92,99,48,351,4906
E9060,85,41,66,89,70,351,4907
E1178,73,56,100,75,47,351,4908
E6353,90,70,80,46,65,351,4909
E1013,60,60,75,82,74,351,4910
E2425,53,48,83,77,90,351,4911
E4358,83,62,65,60,81,351,4912
E7803,83,43,75,77,73,351,4913
E1531,76,92,73,50,60,351,4914
E5082,83,76,48,78,66,351,4915
E0107,79,54,81,81,56,351,4916
E4694,60,66,42,83,100,351,4917
E0437,58,86,95,65,47,351,4918
E1464,69,70,84,67,61,351,4919
E4169,84,56,83,45,83,351,4920
E3332,46,82,86,79,58,351,4921
E0941,67,82,51,64,87,351,4922
E7672,45,91,49,87,79,351,4923
E6624,95,92,73,49,42,351,4924
E9376,67,69,44,78,93,351,4925
E5563,59,74,87,74,57,351,4926
E6447,45,80,76,76,74,351,4927
E3890,89,43,96,78,45,351,4928
E3382,74,91,47,62,77,351,4929
E8858,63,67,83,51,87,351,4930
E8821,96,60,66,64,65,351,4931
E2332,49,88,76,81,57,351,4932
E7523,91,51,58,94,57,351,4933
E4174,97,61,89,43,61,351,4934
E7470,95,49,71,70,66,351,4935
E0104,77,100,69,62,43,351,4936
E4351,71,61,98,43,78,351,4937
E6107,42,100,58,72,79,351,4938
E0002,98,58,75,61,59,351,4939
E7789,94,51,66,92,48,351,4940
E4644,64,64,50,97,76,351,4941
E7960,54,74,86,73,64,351,4942
E1929,51,84,72,78,66,351,4943
E4718,81,96,47,60,67,351,4944
E7259,96,96,45,45,69,351,4945
E3334,93,85,46,58,69,351,4946
E1551,85,73,73,41,79,351,4947
E2191,84,68,57,68,74,351,4948
E5033,42,54,89,67,99,351,4949
E6519,88,74,64,74,51,351,4950
E0495,79,46,45,86,95,351,4951
E6390,87,76,61,62,65,351,4952
E9989,87,60,76,60,68,351,4953
E8176,91,79,46,77,58,351,4954
E3067,56,87,95,43,70,351,4955
E7498,78,69,70,40,94,351,4956
E7918,75,98,52,42,84,351,4957
E8625,52,71,44,86,98,351,4958
E5238,64,49,69,72,97,351,4959
E0282,42,99,92,54,64,351,4960
E2867,63,87,71,88,42,351,4961
E5509,89,83,47,43,89,351,4962
E9527,56,47,73,85,90,351,4963
E1389,63,71,65,68,84,351,4964
E4395,62,53,85,74,77,351,4965
E4808,56,94,84,56,61,351,4966
E3077,47,100,76,78,50,351,4967
E6110,96,67,92,44,52,351,4968
E7028,40,57,90,74,90,351,4969
E2360,93,69,46,89,54,351,4970
E6277,88,66,60,59,78,351,4971
E7866,52,94,92,71,42,351,4972
E5535,97,94,52,63,45,351,4973
E4698,60,74,83,57,77,351,4974
E6092,77,69,41,79,85,351,4975
E1553,68,77,81,51,74,351,4976
E4622,86,49,80,57,79,351,4977
E2665,74,43,78,92,64,351,4978
E1469,57,91,80,40,83,351,4979
E9905,65,74,77,59,76,351,4980
E6579,91,69,46,86,59,351,4981
E3737,62,89,55,86,59,351,4982
E0166,77,66,72,82,54,351,4983
E2453,52,66,97,51,85,351,4984
E7123,63,41,78,100,69,351,4985
E3272,80,53,57,81,79,350,4986
E7535,76,70,58,61,85,350,4987
E1923,64,81,71,62,72,350,4988
E6639,90,90,59,46,65,350,4989
E3912,53,62,51,100,84,350,4990
E5434,89,84,63,73,41,350,4991
E5918,69,48,86,62,85,350,4992
E0445,61,64,60,65,100,350,4993
E2726,100,41,51,74,84,350,4994
E7732,48,99,50,99,54,350,4995
E6804,67,62,66,91,64,350,4996
E2887,65,53,81,68,83,350,4997
E8815,42,94,69,94,51,350,4998
E3574,59,42,66,86,97,350,4999
E7824,51,84,82,45,88,350,5000
E7425,77,90,65,56,62,350,5001
E5079,44,96,74,47,89,350,5002
E5606,99,50,75,50,76,350,5003
E9217,73,94,79,58,46,350,5004
E7793,63,87,80,57,63,350,5005
E1399,46,55,71,95,83,350,5006
E0476,76,71,71,51,81,350,5007
E3704,57,95,49,82,67,350,5008
E3945,51,75,66,65,93,350,5009
E4267,69,75,62,70,74,350,5010
E4094,40,95,73,63,79,350,5011
E0924,42,73,100,74,61,350,5012
E6707,52,72,65,94,67,350,5013
E3956,63,80,86,81,40,350,5014
E7459,77,82,69,57,65,350,5015
E4614,52,66,67,68,97,350,5016
E7656,75,45,84,81,65,350,5017
E2039,76,65,69,74,66,350,5018
E1954,71,54,46,91,88,350,5019
E1820,63,91,72,61,63,350,5020
E1893,69,99,62,77,43,350,5021
E0673,68,80,69,77,56,350,5022
E2364,79,96,69,46,60,350,5023
E7801,53,81,71,55,90,350,5024
E0145,66,82,48,73,81,350,5025
E9877,58,56,55,100,81,350,5026
E6513,76,62,84,68,60,350,5027
E0869,65,96,44,59,86,350,5028
E2478,90,83,47,67,63,350,5029
E1378,52,59,85,65,89,350,5030
E7986,98,60,58,48,86,350,5031
E5634,79,66,69,76,60,350,5032
E2512,80,85,48,68,69,350,5033
E1818,95,57,85,50,63,350,5034
E7302,83,54,66,59,88,350,5035
E8545,44,73,88,45,100,350,5036
E6226,79,73,88,57,53,350,5037
E7012,59,84,72,40,95,350,5038
E1009,86,61,75,71,57,350,5039
E6356,70,61,50,72,97,350,5040
E0986,90,55,71,77,57,350,5041
E3756,48,84,95,50,73,350,5042
E3415,49,78,81,82,60,350,5043
E8259,92,53,93,71,41,350,5044
E4522,78,48,57,84,83,350,5045
E6827,55,81,75,97,42,350,5046
E4017,52,89,82,64,63,350,5047
E6928,69,96,45,85,55,350,5048
E8590,51,94,85,68,52,350,5049
E5630,79,69,99,56,47,350,5050
E1643,63,100,95,45,47,350,5051
E6514,86,88,45,71,60,350,5052
E6381,55,80,77,60,78,350,5053
E2323,90,86,79,50,45,350,5054
E1321,61,61,76,98,54,350,5055
E6594,93,76,73,55,53,350,5056
E3621,67,86,48,59,90,350,5057
E5839,54,87,96,72,41,350,5058
E9451,42,96,91,69,52,350,5059
E5412,63,45,72,87,83,350,5060
E3657,100,85,43,52,70,350,5061
E3580,88,48,98,73,43,350,5062
E5743,54,75,63,58,100,350,5063
E9508,94,55,60,69,72,350,5064
E3175,83,55,82,45,85,350,5065
E1176,62,68,73,90,57,350,5066
E3599,43,69,98,65,75,350,5067
E1237,88,43,82,70,67,350,5068
E8236,79,48,85,81,57,350,5069
E0317,52,85,87,40,86,350,5070
E8365,88,58,57,96,51,350,5071
E0878,93,75,41,43,98,350,5072
E1465,83,49,41,86,91,350,5073
E4328,80,58,88,55,69,350,5074
E8140,72,50,82,95,51,350,5075
E0945,61,52,95,49,93,350,5076
E4520,92,86,56,75,41,350,5077
E4052,70,54,85,84,57,350,5078
E9604,48,66,69,86,81,350,5079
E8342,65,70,81,52,82,350,5080
E9261,40,93,75,94,48,350,5081
E0207,61,76,87,64,62,350,5082
E9170,85,55,69,47,94,350,5083
E1876,46,64,91,69,80,350,5084
E4232,86,100,61,59,44,350,5085
E7477,92,47,77,66,68,350,5086
E1026,64,77,78,59,72,350,5087
E9652,71,86,62,64,66,349,5088
E5521,68,78,64,48,91,349,5089
E4636,64,80,74,70,61,349,5090
E6853,51,84,51,63,100,349,5091
E9757,81,66,58,77,67,349,5092
E2818,62,59,76,76,76,349,5093
E6227,88,54,89,75,43,349,5094
E4022,69,43,78,65,94,349,5095
E3897,88,40,90,76,55,349,5096
E1347,45,89,89,59,67,349,5097
E4197,97,71,43,72,66,349,5098
E4104,41,89,81,98,40,349,5099
E6695,76,59,89,45,80,349,5100
E8117,71,76,83,68,51,349,5101
E9637,67,50,97,59,76,349,5102
E3434,90,44,93,41,81,349,5103
E4441,68,86,53,80,62,349,5104
E4787,85,63,67,66,68,349,5105
E6805,66,63,82,45,93,349,5106
E8962,83,89,73,54,50,349,5107
E8599,65,75,80,75,54,349,5108
E0446,86,52,87,46,78,349,5109
E1746,93,61,70,81,44,349,5110
E0726,65,79,64,42,99,349,5111
E8499,93,90,69,57,40,349,5112
E6243,46,50,74,90,89,349,5113
E2599,41,83,55,83,87,349,5114
E2223,66,77,63,95,48,349,5115
E1437,55,70,79,73,72,349,5116
E9781,50,67,95,43,94,349,5117
E0523,52,94,80,80,43,349,5118
E7301,72,89,70,74,44,349,5119
E0943,60,70,41,81,97,349,5120
E2920,92,76,65,64,52,349,5121
E8790,92,59,90,59,49,349,5122
E8676,58,79,70,81,61,349,5123
E0283,62,44,65,86,92,349,5124
E9233,55,72,74,91,57,349,5125
E7996,85,45,60,99,60,349,5126
E6626,72,61,57,68,91,349,5127
E5627,91,60,43,85,70,349,5128
E2227,53,74,61,100,61,349,5129
E9753,61,81,51,61,95,349,5130
E0611,43,66,89,64,87,349,5131
E4488,45,71,93,77,63,349,5132
E9338,82,52,63,85,67,349,5133
E4824,56,49,69,96,79,349,5134
E3968,49,44,98,91,67,349,5135
E9163,88,52,79,77,53,349,5136
E8324,75,98,72,47,57,349,5137
E4558,84,43,70,96,56,349,5138
E8205,60,97,77,55,60,349,5139
E0273,100,66,71,50,62,349,5140
E5917,77,86,74,48,64,349,5141
E0527,67,93,60,46,83,349,5142
E8857,90,54,79,79,47,349,5143
E7254,72,88,60,45,84,349,5144
E7126,54,43,76,86,90,349,5145
E5388,90,79,50,45,85,349,5146
E7869,62,84,63,66,74,349,5147
E2525,65,50,66,74,94,349,5148
E0927,95,77,40,95,42,349,5149
E6018,86,80,64,55,64,349,5150
E7319,64,40,98,79,68,349,5151
E4770,53,82,69,77,68,349,5152
E9171,65,43,84,81,76,349,5153
E6387,73,69,48,85,74,349,5154
E7294,64,81,62,76,66,349,5155
E8264,47,56,64,89,93,349,5156
E1791,49,81,85,50,84,349,5157
E1775,86,92,67,45,59,349,5158
E9711,95,72,68,44,70,349,5159
E2514,57,51,73,88,80,349,5160
E8777,90,62,68,48,81,349,5161
E2576,73,52,91,87,46,349,5162
E2367,66,45,73,71,94,349,5163
E0103,49,95,85,45,75,349,5164
E8646,58,66,76,58,91,349,5165
E0264,46,78,78,82,65,349,5166
E4753,66,85,82,58,58,349,5167
E9613,43,82,80,77,67,349,5168
E7143,95,61,84,54,55,349,5169
E3893,72,65,92,41,79,349,5170
E0335,62,72,71,53,91,349,5171
E4775,79,63,75,81,51,349,5172
E0779,72,53,66,92,66,349,5173
E2980,97,68,55,80,49,349,5174
E5015,68,74,100,50,57,349,5175
E9993,46,49,77,96,81,349,5176
E0729,55,45,75,88,86,349,5177
E5820,69,97,62,71,50,349,5178
E4769,45,91,87,69,57,349,5179
E8160,76,58,91,58,66,349,5180
E7474,68,68,49,75,89,349,5181
E8871,40,75,71,71,92,349,5182
E4029,97,57,85,45,65,349,5183
E4133,86,48,88,60,67,349,5184
E8714,55,64,51,79,100,349,5185
E2832,76,61,45,84,82,348,5186
E0583,86,100,42,59,61,348,5187
E4460,49,73,80,47,99,348,5188
E1502,100,64,66,42,76,348,5189
E1639,59,69,83,67,70,348,5190
E5009,68,84,52,51,93,348,5191
E3405,66,69,47,78,88,348,5192
E8233,81,50,98,75,44,348,5193
E1778,59,63,96,87,43,348,5194
E0340,69,73,56,59,91,348,5195
E7420,48,58,89,56,97,348,5196
E6587,60,83,64,96,45,348,5197
E4401,47,78,93,59,71,348,5198
E6681,84,79,71,43,71,348,5199
E7556,77,64,42,77,88,348,5200
E6958,98,64,58,47,81,348,5201
E8560,63,60,56,87,82,348,5202
E4063,85,65,66,74,58,348,5203
E9258,92,41,80,65,70,348,5204
E9772,59,45,55,93,96,348,5205
E6649,100,61,59,61,67,348,5206
E6109,64,88,71,80,45,348,5207
E6137,58,62,84,53,91,348,5208
E9912,52,60,66,92,78,348,5209
E4014,81,79,49,43,96,348,5210
E2330,67,79,82,50,70,348,5211
E7167,74,68,97,57,52,348,5212
E6487,97,46,85,80,40,348,5213
E8010,53,52,82,96,65,348,5214
E4283,97,47,78,56,70,348,5215
E3052,46,92,95,59,56,348,5216
E2264,95,56,80,42,75,348,5217
E8011,40,68,81,63,96,348,5218
E6620,60,94,48,67,79,348,5219
E1029,69,60,76,51,92,348,5220
E2531,89,57,77,51,74,348,5221
E3033,100,79,63,44,62,348,5222
E5580,40,43,74,94,97,348,5223
E7746,75,44,90,95,44,348,5224
E6372,79,90,70,56,53,348,5225
E1407,63,64,91,63,67,348,5226
E4683,65,94,45,80,64,348,5227
E9026,98,54,64,45,87,348,5228
E7410,95,76,72,48,57,348,5229
E5998,92,75,75,65,41,348,5230
E4889,60,92,57,52,87,348,5231
E0688,88,41,63,100,56,348,5232
E2357,73,62,60,68,85,348,5233
E0502,79,42,91,57,79,348,5234
E5854,87,86,47,78,50,348,5235
E1060,69,67,49,91,72,348,5236
E1591,65,54,68,91,70,348,5237
E5024,99,40,54,60,95,348,5238
E6366,73,46,50,89,90,348,5239
E8248,49,73,69,59,98,348,5240
E3731,47,67,56,93,85,348,5241
E6962,74,88,50,82,54,348,5242
E9022,70,60,81,41,96,348,5243
E1834,48,70,84,70,76,348,5244
E4436,67,53,82,82,64,348,5245
E3307,75,43,84,93,53,348,5246
E3769,76,79,47,77,69,348,5247
E7348,68,74,62,58,86,348,5248
E5305,52,74,55,95,72,348,5249
E1966,45,66,72,99,66,348,5250
E9120,44,86,52,74,92,348,5251
E1725,60,41,68,88,91,348,5252
E9845,50,68,71,67,92,348,5253
E3354,70,61,95,42,80,348,5254
E8535,97,92,55,55,49,348,5255
E3637,55,75,70,78,70,348,5256
E2336,52,94,76,46,80,348,5257
E2413,76,45,90,65,72,348,5258
E0773,42,99,94,45,68,348,5259
E9388,42,66,62,91,87,348,5260
E2856,100,63,55,60,70,348,5261
E3855,84,92,70,58,44,348,5262
E6950,55,100,73,53,67,348,5263
E8061,86,57,97,53,55,348,5264
E9577,100,87,80,40,41,348,5265
E1607,64,71,62,63,88,348,5266
E6113,73,71,69,67,68,348,5267
E4882,86,47,65,51,99,348,5268
E7605,94,80,69,58,47,348,5269
E9885,59,67,43,87,92,348,5270
E5389,75,58,78,46,91,348,5271
E5922,75,51,99,70,53,348,5272
E5252,90,91,59,40,68,348,5273
E0191,98,47,70,85,48,348,5274
E3502,99,92,40,63,54,348,5275
E5864,54,84,72,64,74,348,5276
E6218,50,93,85,69,51,348,5277
E1184,51,63,78,63,93,348,5278
E9266,84,68,52,46,98,348,5279
E5891,74,56,53,92,73,348,5280
E9297,85,74,57,47,85,348,5281
E4909,63,51,84,76,74,348,5282
E1667,81,54,57,85,71,348,5283
E6328,80,44,75,60,89,348,5284
E6068,97,70,81,48,52,348,5285
E6921,84,61,55,93,54,347,5286
E8351,59,72,43,76,97,347,5287
E8158,63,93,40,97,54,347,5288
E2090,55,97,41,59,95,347,5289
E1374,84,70,80,59,54,347,5290
E6521,91,94,54,50,58,347,5291
E2642,63,93,50,42,99,347,5292
E0735,63,82,87,71,44,347,5293
E0806,54,61,40,94,98,347,5294
E4667,41,100,41,80,85,347,5295
E6433,54,100,40,58,95,347,5296
E0724,48,59,80,69,91,347,5297
E2804,69,58,63,57,100,347,5298
E2728,65,79,78,81,44,347,5299
E9640,97,61,96,50,43,347,5300
E9147,92,88,49,72,46,347,5301
E2715,48,64,89,57,89,347,5302
E3289,72,64,74,45,92,347,5303
E5894,99,53,79,40,76,347,5304
E9345,65,45,81,94,62,347,5305
E7806,59,98,98,40,52,347,5306
E7044,62,99,42,60,84,347,5307
E9574,51,94,49,92,61,347,5308
E9409,56,67,98,44,82,347,5309
E2882,50,82,88,60,67,347,5310
E0236,71,57,86,75,58,347,5311
E2230,55,41,97,94,60,347,5312
E1412,95,57,59,44,92,347,5313
E0242,63,41,91,63,89,347,5314
E9309,97,73,60,41,76,347,5315
E3388,68,61,68,94,56,347,5316
E2670,52,48,87,89,71,347,5317
E2826,80,87,63,53,64,347,5318
E6279,56,64,83,92,52,347,5319
E3722,91,55,41,96,64,347,5320
E5051,61,95,49,86,56,347,5321
E4103,85,55,65,96,46,347,5322
E1425,58,72,62,78,77,347,5323
E3679,64,71,90,66,56,347,5324
E2352,67,80,56,71,73,347,5325
E4223,75,59,60,84,69,347,5326
E4489,77,45,93,70,62,347,5327
E2234,73,72,50,64,88,347,5328
E0844,41,93,46,94,73,347,5329
E0418,44,70,94,55,84,347,5330
E8146,52,58,94,95,48,347,5331
E3778,55,63,78,79,72,347,5332
E6538,73,47,69,93,65,347,5333
E9955,86,54,50,75,82,347,5334
E5812,47,89,61,98,52,347,5335
E0287,97,52,43,80,75,347,5336
E3027,99,53,42,62,91,347,5337
E8183,56,95,46,69,81,347,5338
E3250,55,91,98,59,44,347,5339
E3594,85,71,50,78,63,347,5340
E9969,52,86,42,73,94,347,5341
E9130,54,82,72,73,66,347,5342
E0854,58,42,100,55,92,347,5343
E8727,65,49,79,68,86,347,5344
E5903,73,45,81,76,72,347,5345
E6375,56,55,87,84,65,347,5346
E4263,67,67,66,48,99,347,5347
E8468,54,44,94,97,58,347,5348
E4189,53,97,80,63,54,347,5349
E4865,71,65,73,90,48,347,5350
E7544,65,62,59,82,79,347,5351
E6951,43,81,70,62,91,347,5352
E3188,99,47,61,75,65,347,5353
E5816,47,97,95,63,45,347,5354
E3953,96,72,48,71,60,347,5355
E7953,82,83,92,47,43,347,5356
E7313,62,47,78,87,73,347,5357
E0480,45,88,62,99,53,347,5358
E6996,50,51,81,94,71,347,5359
E7835,63,85,65,93,41,347,5360
E7137,96,50,95,48,58,347,5361
E5289,70,84,56,81,56,347,5362
E4525,51,52,71,75,98,347,5363
E0177,87,40,73,74,73,347,5364
E1319,83,41,47,81,95,347,5365
E2751,41,83,66,69,87,346,5366
E8701,74,54,54,97,67,346,5367
E6999,44,84,85,68,65,346,5368
E2649,54,72,90,88,42,346,5369
E0141,55,73,58,67,93,346,5370
E3753,58,61,91,46,90,346,5371
E4669,74,71,42,62,97,346,5372
E6565,62,64,71,94,55,346,5373
E0934,99,42,61,65,79,346,5374
E7733,53,59,88,59,87,346,5375
E7699,89,51,60,71,75,346,5376
E1439,91,41,65,77,72,346,5377
E2131,55,91,93,40,67,346,5378
E7554,79,82,61,64,60,346,5379
E0391,91,48,52,82,73,346,5380
E2047,75,85,59,87,40,346,5381
E5190,40,93,89,82,42,346,5382
E4552,89,63,48,64,82,346,5383
E6691,58,58,99,78,53,346,5384
E0564,76,78,71,45,76,346,5385
E0858,78,75,81,50,62,346,5386
E6081,94,91,47,53,61,346,5387
E0538,94,43,58,94,57,346,5388
E5877,91,77,58,70,50,346,5389
E3187,88,75,43,77,63,346,5390
E7236,98,52,59,77,60,346,5391
E9164,66,48,85,98,49,346,5392
E4422,44,57,92,96,57,346,5393
E9492,77,61,95,71,42,346,5394
E6535,100,40,86,74,46,346,5395
E1561,89,71,43,74,69,346,5396
E8908,40,65,44,99,98,346,5397
E5250,83,70,52,87,54,346,5398
E5083,87,73,66,46,74,346,5399
E3692,53,82,46,68,97,346,5400
E5746,47,100,52,48,99,346,5401
E9214,82,93,41,40,90,346,5402
E5889,82,67,78,74,45,346,5403
E0499,72,65,50,98,61,346,5404
E8851,67,62,99,42,76,346,5405
E0649,85,48,98,63,52,346,5406
E1289,78,63,87,40,78,346,5407
E4871,90,86,68,47,55,346,5408
E1171,85,74,50,41,96,346,5409
E3073,86,58,60,92,50,346,5410
E8367,50,79,60,65,92,346,5411
E0327,51,56,59,89,91,346,5412
E5303,60,82,50,76,78,346,5413
E2424,71,82,71,80,42,346,5414
E5965,55,95,63,55,78,346,5415
E0744,40,87,58,68,93,346,5416
E0839,79,61,89,60,57,346,5417
E6862,55,62,70,100,59,346,5418
E9232,90,64,65,72,55,346,5419
E0151,90,40,99,59,58,346,5420
E4960,50,77,80,84,55,346,5421
E1069,57,69,58,66,96,346,5422
E4138,70,59,60,96,61,346,5423
E3983,72,90,80,45,59,346,5424
E5712,45,61,90,94,56,346,5425
E8670,62,79,59,82,64,346,5426
E0834,53,49,89,58,97,346,5427
E6494,56,92,44,80,74,346,5428
E9589,71,58,66,67,84,346,5429
E0896,99,57,60,80,50,346,5430
E3400,60,73,85,48,80,346,5431
E8403,75,69,76,83,43,346,5432
E6644,48,58,80,64,96,346,5433
E4822,78,91,79,53,45,346,5434
E2915,65,65,63,89,64,346,5435
E3248,41,98,51,96,60,346,5436
E7751,42,47,77,81,99,346,5437
E7329,40,54,80,97,75,346,5438
E8529,69,62,78,58,79,346,5439
E0910,53,49,99,93,52,346,5440
E0434,63,80,71,42,90,346,5441
E8151,88,65,59,62,72,346,5442
E7984,60,87,53,54,92,346,5443
E4042,62,79,69,57,79,346,5444
E3645,77,42,94,58,75,346,5445
E2361,69,63,76,98,40,346,5446
E8380,96,81,40,85,44,346,5447
E9687,91,83,88,43,41,346,5448
E1109,65,53,83,94,51,346,5449
E3811,46,95,93,68,44,346,5450
E7926,74,85,67,66,54,346,5451
E7857,76,52,74,86,58,346,5452
E9426,57,90,95,56,48,346,5453
E9728,62,75,63,99,47,346,5454
E8438,60,63,52,79,92,346,5455
E3320,84,51,62,99,50,346,5456
E3369,61,93,86,48,58,346,5457
E5350,74,68,77,43,84,346,5458
E4319,81,95,50,74,46,346,5459
E0623,42,94,51,78,81,346,5460
E2682,85,42,80,88,51,346,5461
E7356,71,79,52,69,75,346,5462
E4611,68,48,96,76,58,346,5463
E5940,66,80,90,53,57,346,5464
E0562,57,96,47,53,93,346,5465
E2094,79,85,54,83,45,346,5466
E7909,96,74,56,78,42,346,5467
E3235,43,89,63,98,53,346,5468
E7615,73,97,73,43,60,346,5469
E8481,58,79,86,53,70,346,5470
E8997,81,79,55,87,44,346,5471
E2416,67,90,46,54,89,346,5472
E2740,56,42,87,79,82,346,5473
E7688,40,62,97,95,52,346,5474
E4173,66,59,66,99,56,346,5475
E4645,98,85,69,51,43,346,5476
E6002,71,69,85,76,45,346,5477
E0548,99,68,67,53,59,346,5478
E5230,72,81,84,65,44,346,5479
E0305,86,42,47,82,89,346,5480
E7070,91,91,42,63,59,346,5481
E3364,78,75,49,74,70,346,5482
E3169,40,66,97,94,48,345,5483
E4259,86,48,75,49,87,345,5484
E6894,44,82,65,61,93,345,5485
E2863,95,56,68,79,47,345,5486
E3857,56,82,42,74,91,345,5487
E7161,67,81,56,63,78,345,5488
E6597,73,88,59,58,67,345,5489
E6559,91,78,45,65,66,345,5490
E1467,41,81,73,60,90,345,5491
E0293,94,44,47,100,60,345,5492
E0105,55,89,45,92,64,345,5493
E7052,53,95,69,78,50,345,5494
E3481,62,80,91,42,70,345,5495
E0432,95,42,48,88,72,345,5496
E2877,42,46,96,66,95,345,5497
E2838,44,52,88,99,62,345,5498
E8221,51,47,83,98,66,345,5499
E1943,53,87,85,80,40,345,5500
E1924,57,82,100,58,48,345,5501
E3525,68,76,75,61,65,345,5502
E0722,78,85,92,48,42,345,5503
E7057,100,92,71,42,40,345,5504
E4084,57,91,75,62,60,345,5505
E3532,60,73,82,59,71,345,5506
E2916,71,69,70,55,80,345,5507
E1856,89,62,41,81,72,345,5508
E1788,83,76,91,42,53,345,5509
E2320,58,99,44,58,86,345,5510
E4011,78,72,80,60,55,345,5511
E5849,43,41,84,93,84,345,5512
E8132,84,52,77,64,68,345,5513
E8432,74,50,91,41,89,345,5514
E9859,48,43,64,99,91,345,5515
E9270,81,48,99,73,44,345,5516
E1544,47,57,88,57,96,345,5517
E8834,82,43,77,67,76,345,5518
E6645,78,63,82,42,80,345,5519
E3333,51,86,40,71,97,345,5520
E5985,42,80,88,60,75,345,5521
E6278,90,66,41,53,95,345,5522
E3223,63,75,77,73,57,345,5523
E4269,51,99,48,95,52,345,5524
E9190,72,74,87,52,60,345,5525
E9673,96,46,99,55,49,345,5526
E8208,87,80,69,68,41,345,5527
E7715,68,83,74,78,42,345,5528
E8230,52,44,76,88,85,345,5529
E2217,65,88,86,62,44,345,5530
E1762,68,59,76,52,90,345,5531
E2511,59,51,98,74,63,345,5532
E7598,43,97,78,76,51,345,5533
E7194,75,63,100,41,66,345,5534
E9440,89,98,53,57,48,345,5535
E5719,56,74,60,90,65,345,5536
E2506,75,49,66,94,61,345,5537
E1136,57,51,70,75,92,345,5538
E2881,51,76,79,43,96,345,5539
E7905,62,40,65,78,100,345,5540
E8903,89,48,64,85,59,345,5541
E0883,63,91,82,62,47,345,5542
E8288,93,72,59,57,64,345,5543
E0149,47,91,72,92,43,345,5544
E5927,67,93,63,75,47,345,5545
E2068,63,73,70,47,92,345,5546
E5003,53,99,60,61,72,345,5547
E8421,75,81,56,88,45,345,5548
E6815,51,49,89,77,79,345,5549
E4119,77,66,90,53,59,345,5550
E5566,79,76,45,50,95,345,5551
E1238,87,52,81,55,70,345,5552
E7500,79,84,70,60,52,345,5553
E1539,74,50,65,92,64,345,5554
E1151,72,82,50,93,48,345,5555
E9070,61,77,49,77,81,345,5556
E1303,57,46,86,67,89,345,5557
E5135,43,60,72,79,91,345,5558
E3106,100,62,58,65,60,345,5559
E8337,66,85,66,77,51,345,5560
E5880,77,81,44,69,74,345,5561
E8192,40,91,58,75,81,345,5562
E7938,59,98,66,49,73,345,5563
E6701,73,46,69,64,93,345,5564
E1224,78,90,60,64,53,345,5565
E8097,57,44,100,70,74,345,5566
E7108,77,71,60,50,87,345,5567
E5494,49,82,59,63,92,345,5568
E5734,83,80,63,73,46,345,5569
E1316,84,84,69,59,49,345,5570
E7707,62,74,74,44,91,345,5571
E4475,80,57,69,68,71,345,5572
E2466,84,41,56,68,96,345,5573
E3742,67,85,47,54,92,345,5574
E9556,87,49,75,58,76,345,5575
E0388,54,60,90,81,60,345,5576
E7766,77,75,42,80,71,345,5577
E8029,81,91,53,62,58,345,5578
E2515,40,77,62,70,96,345,5579
E2484,54,46,87,82,76,345,5580
E0565,41,48,93,91,72,345,5581
E6500,96,42,90,41,76,345,5582
E6979,85,97,44,75,44,345,5583
E1745,49,63,91,78,63,344,5584
E8550,58,79,79,77,51,344,5585
E9092,47,86,59,56,96,344,5586
E4113,72,57,95,49,71,344,5587
E9320,72,69,55,99,49,344,5588
E5477,92,89,49,60,54,344,5589
E0784,82,40,93,63,66,344,5590
E6929,44,91,88,49,72,344,5591
E0281,86,45,45,96,72,344,5592
E6459,45,89,68,42,100,344,5593
E0603,76,40,77,77,74,344,5594
E0204,65,46,96,84,53,344,5595
E1677,62,40,52,95,95,344,5596
E5414,73,42,89,62,78,344,5597
E3110,90,79,53,61,61,344,5598
E2472,73,56,96,59,60,344,5599
E6737,48,67,40,99,90,344,5600
E6179,40,64,96,76,68,344,5601
E4129,57,87,62,50,88,344,5602
E0803,45,94,90,74,41,344,5603
E4548,95,63,47,71,68,344,5604
E0213,57,65,60,91,71,344,5605
E7991,52,53,63,96,80,344,5606
E0114,73,58,76,82,55,344,5607
E9035,43,100,51,98,52,344,5608
E9251,90,99,60,55,40,344,5609
E0867,67,100,61,71,45,344,5610
E5214,86,51,58,99,50,344,5611
E1506,48,48,59,91,98,344,5612
E5532,58,97,48,70,71,344,5613
E0053,49,93,52,66,84,344,5614
E3450,81,66,53,88,56,344,5615
E6071,84,90,57,70,43,344,5616
E6530,70,80,98,50,46,344,5617
E0493,63,67,76,58,80,344,5618
E0799,63,65,68,51,97,344,5619
E9380,49,75,88,60,72,344,5620
E4397,60,75,89,73,47,344,5621
E0014,87,86,78,44,49,344,5622
E3213,46,51,65,88,94,344,5623
E7995,51,86,54,93,60,344,5624
E1229,65,51,87,88,53,344,5625
E0481,40,77,97,69,61,344,5626
E7701,69,68,49,72,86,344,5627
E6570,87,83,41,55,78,344,5628
E9739,77,60,72,75,60,344,5629
E6704,52,84,89,45,74,344,5630
E4502,53,95,57,50,89,344,5631
E9004,50,97,78,75,44,344,5632
E5959,44,64,62,87,87,344,5633
E9926,89,42,53,80,80,344,5634
E0746,54,74,95,75,46,344,5635
E1967,88,62,59,50,85,344,5636
E4451,84,61,68,64,67,344,5637
E7856,52,87,52,74,79,344,5638
E1625,40,92,65,68,79,344,5639
E1428,42,53,94,80,75,344,5640
E9257,91,90,70,52,41,344,5641
E6841,77,74,62,43,88,344,5642
E7373,64,67,64,88,61,344,5643
E9136,100,46,70,82,46,344,5644
E8506,74,66,71,92,41,344,5645
E1201,88,57,57,67,75,344,5646
E5021,81,44,83,52,84,344,5647
E5090,93,55,52,64,80,344,5648
E4447,100,70,74,45,55,344,5649
E9048,82,40,98,69,55,344,5650
E4389,44,79,58,80,83,344,5651
E9186,76,50,92,46,80,344,5652
E2719,71,68,45,67,93,344,5653
E8347,75,59,43,100,67,344,5654
E9841,56,80,48,73,87,344,5655
E5067,83,43,45,86,87,344,5656
E6505,83,82,44,44,91,344,5657
E0117,72,69,46,83,74,344,5658
E7674,47,61,40,100,96,344,5659
E0556,41,65,86,78,74,344,5660
E5329,83,63,47,61,90,344,5661
E5552,51,78,40,93,82,344,5662
E0969,45,85,72,46,96,344,5663
E5975,56,75,59,71,83,344,5664
E3239,51,68,70,94,61,344,5665
E8915,84,52,77,57,74,344,5666
E8398,46,75,83,57,83,344,5667
E4569,80,41,92,80,51,344,5668
E4062,100,100,57,47,40,344,5669
E6211,83,47,79,65,70,344,5670
E5022,59,61,82,85,57,344,5671
E9221,57,85,83,67,52,344,5672
E5341,66,83,51,82,62,344,5673
E5752,53,81,62,65,83,344,5674
E9274,91,59,74,73,47,344,5675
E5043,80,45,45,92,81,343,5676
E4981,94,92,58,41,58,343,5677
E7763,70,52,97,67,57,343,5678
E5025,92,52,80,69,50,343,5679
E6472,87,52,66,67,71,343,5680
E4594,88,41,90,67,57,343,5681
E0286,96,89,54,57,47,343,5682
E1739,90,51,42,97,63,343,5683
E2353,99,46,99,48,51,343,5684
E4417,100,41,74,55,73,343,5685
E0067,100,59,52,59,73,343,5686
E4256,42,80,91,68,62,343,5687
E8239,67,47,63,84,82,343,5688
E5352,66,74,89,45,69,343,5689
E7250,58,94,75,72,44,343,5690
E5718,47,49,73,76,98,343,5691
E4074,45,69,74,81,74,343,5692
E1167,57,70,75,46,95,343,5693
E2575,45,78,87,74,59,343,5694
E4823,49,84,42,80,88,343,5695
E2272,46,78,55,67,97,343,5696
E0119,93,79,42,78,51,343,5697
E5220,70,77,56,100,40,343,5698
E2123,41,88,61,73,80,343,5699
E2858,56,90,97,47,53,343,5700
E2662,78,72,63,46,84,343,5701
E4592,90,88,43,61,61,343,5702
E5920,84,46,56,69,88,343,5703
E3044,64,84,46,64,85,343,5704
E8201,76,55,92,74,46,343,5705
E6501,80,78,42,91,52,343,5706
E3703,93,75,44,67,64,343,5707
E4505,62,58,41,99,83,343,5708
E7660,94,76,51,48,74,343,5709
E2529,92,79,68,52,52,343,5710
E5455,59,83,70,65,66,343,5711
E2787,66,65,84,69,59,343,5712
E0754,75,58,98,67,45,343,5713
E1414,68,72,58,67,78,343,5714
E2667,91,51,65,44,92,343,5715
E8322,67,100,56,49,71,343,5716
E8329,73,91,91,47,41,343,5717
E2651,65,52,57,86,83,343,5718
E2201,63,72,57,77,74,343,5719
E1345,79,81,69,54,60,343,5720
E8422,69,58,94,56,66,343,5721
E7124,68,84,51,51,89,343,5722
E1268,47,60,90,73,73,343,5723
E4478,61,56,65,65,96,343,5724
E6319,63,64,80,84,52,343,5725
E3932,54,59,57,87,86,343,5726
E8057,68,73,97,44,61,343,5727
E3822,41,92,99,54,57,343,5728
E0060,43,92,78,88,42,343,5729
E5062,80,93,52,77,41,343,5730
E1071,69,94,67,42,71,343,5731
E2033,71,61,85,42,84,343,5732
E6582,53,76,71,63,80,343,5733
E6075,86,50,67,45,95,343,5734
E9307,45,100,63,85,50,343,5735
E6632,84,55,90,42,72,343,5736
E4798,63,58,43,84,95,343,5737
E2242,51,47,90,66,89,343,5738
E1277,77,54,54,60,98,343,5739
E6569,83,60,78,73,49,343,5740
E7848,98,82,44,54,65,343,5741
E1175,77,67,61,56,82,343,5742
E7914,63,72,43,72,93,343,5743
E1934,83,46,89,46,79,343,5744
E5319,61,69,93,45,75,343,5745
E9639,82,61,53,67,80,343,5746
E8742,66,65,47,70,95,343,5747
E6729,63,49,40,95,96,343,5748
E3061,74,50,52,76,91,343,5749
E5568,88,57,52,66,80,343,5750
E0111,88,42,44,85,84,343,5751
E5994,61,45,76,99,62,343,5752
E9533,72,45,66,78,82,343,5753
E8724,78,57,76,77,55,343,5754
E0376,98,72,83,41,49,343,5755
E1912,46,68,42,96,91,343,5756
E3522,68,49,96,60,70,343,5757
E4118,64,92,67,49,71,343,5758
E3166,45,79,92,58,69,343,5759
E8841,69,89,54,69,62,343,5760
E5837,56,73,91,41,82,343,5761
E2180,43,97,90,60,53,343,5762
E5753,65,62,96,66,54,343,5763
E1630,57,66,60,75,85,343,5764
E1247,51,88,95,49,60,343,5765
E7380,80,44,68,70,81,343,5766
E4242,68,95,58,47,75,343,5767
E3356,68,48,73,93,61,343,5768
E3066,54,73,82,68,66,343,5769
E2585,59,54,83,87,60,343,5770
E3746,71,57,56,60,99,343,5771
E6030,67,68,89,41,78,343,5772
E0219,60,48,91,45,99,343,5773
E2319,59,69,57,74,84,343,5774
E5694,47,100,42,96,58,343,5775
E2578,67,40,69,84,83,343,5776
E3614,48,100,45,72,78,343,5777
E8639,99,56,58,76,54,343,5778
E4536,74,63,86,45,75,343,5779
E9331,80,51,81,85,46,343,5780
E1291,81,41,66,80,75,343,5781
E2037,67,75,74,52,74,342,5782
E8110,49,50,86,78,79,342,5783
E6228,87,77,55,65,58,342,5784
E1183,55,52,86,89,60,342,5785
E4095,76,92,49,49,76,342,5786
E4968,45,45,72,80,100,342,5787
E9267,90,83,65,60,44,342,5788
E1490,82,44,83,76,57,342,5789
E6300,53,93,45,79,72,342,5790
E3324,70,62,81,54,75,342,5791
E2864,64,84,61,62,71,342,5792
E9466,78,86,50,42,86,342,5793
E8508,51,69,75,49,98,342,5794
E4937,55,47,65,85,90,342,5795
E8484,98,47,46,92,59,342,5796
E3445,90,93,57,57,45,342,5797
E6418,61,61,77,52,91,342,5798
E8770,92,50,80,57,63,342,5799
E5860,83,81,42,94,42,342,5800
E1597,57,72,98,70,45,342,5801
E1287,84,53,48,67,90,342,5802
E2497,46,84,83,58,71,342,5803
E7768,72,68,88,66,48,342,5804
E7260,94,51,100,57,40,342,5805
E6463,96,68,53,45,80,342,5806
E4444,97,78,57,47,63,342,5807
E6017,41,75,63,84,79,342,5808
E9558,74,81,72,56,59,342,5809
E2150,63,96,90,43,50,342,5810
E5077,58,67,98,79,40,342,5811
E1187,85,75,69,65,48,342,5812
E0772,58,41,81,83,79,342,5813
E9559,95,40,56,76,75,342,5814
E3156,65,48,76,76,77,342,5815
E9929,99,60,57,83,43,342,5816
E7175,87,67,61,46,81,342,5817
E1308,65,78,97,56,46,342,5818
E9094,87,47,76,40,92,342,5819
E2823,88,58,74,67,55,342,5820
E1122,99,79,45,44,75,342,5821
E9643,92,46,76,43,85,342,5822
E0655,48,73,82,77,62,342,5823
E5441,79,90,46,87,40,342,5824
E0977,73,85,47,88,49,342,5825
E9898,53,62,70,89,68,342,5826
E5046,51,72,54,73,92,342,5827
E1170,63,66,71,98,44,342,5828
E7997,97,92,43,47,63,342,5829
E4887,56,78,82,42,84,342,5830
E4945,91,53,65,67,66,342,5831
E6134,58,68,75,65,76,342,5832
E9231,48,80,57,70,87,342,5833
E1881,53,62,79,62,86,342,5834
E2001,41,76,88,48,89,342,5835
E0308,78,88,44,63,69,342,5836
E0494,83,71,46,97,45,342,5837
E4085,76,70,81,72,43,342,5838
E1956,76,95,81,43,47,342,5839
E3108,48,42,90,75,87,342,5840
E8730,84,71,41,76,70,342,5841
E1485,89,57,62,91,43,342,5842
E3805,99,62,76,63,42,342,5843
E9446,51,69,45,80,97,342,5844
E3390,66,95,56,46,79,342,5845
E8657,54,92,53,57,86,342,5846
E0225,68,66,79,47,82,342,5847
E4207,73,56,97,68,48,342,5848
E0255,45,64,67,91,75,342,5849
E0039,46,57,75,95,69,342,5850
E2919,98,57,55,45,87,342,5851
E7719,48,88,48,78,80,342,5852
E1828,72,81,86,46,57,342,5853
E9671,98,86,65,46,47,342,5854
E7230,64,57,48,75,98,342,5855
E2284,86,40,67,89,60,342,5856
E3491,51,84,62,93,52,342,5857
E4349,97,57,93,50,45,342,5858
E8114,67,43,75,87,70,342,5859
E6039,80,40,66,80,76,342,5860
E7193,44,80,92,70,56,342,5861
E8359,84,47,71,53,87,342,5862
E4843,49,65,41,89,98,342,5863
E6460,96,68,81,41,56,342,5864
E0394,60,51,91,69,71,342,5865
E6687,51,92,83,69,47,342,5866
E2797,88,66,42,74,72,342,5867
E7964,70,100,41,47,84,342,5868
E1548,64,71,55,88,64,342,5869
E6064,40,71,88,84,59,342,5870
E8778,90,40,42,79,91,342,5871
E5942,46,71,80,86,59,342,5872
E8913,58,76,73,94,41,342,5873
E1846,76,100,78,40,48,342,5874
E4851,58,40,97,57,90,342,5875
E7084,49,90,56,79,68,342,5876
E9986,48,56,96,71,71,342,5877
E1456,88,65,66,75,48,342,5878
E9959,93,64,49,50,86,342,5879
E7742,97,66,47,77,55,342,5880
E6683,83,78,56,56,69,342,5881
E0279,89,56,45,53,99,342,5882
E9210,88,53,54,80,67,342,5883
E3550,92,85,51,71,43,342,5884
E9387,82,95,47,61,56,341,5885
E0044,79,74,66,53,69,341,5886
E3881,65,64,62,100,50,341,5887
E9128,48,63,95,80,55,341,5888
E4030,49,97,50,54,91,341,5889
E2059,71,62,85,79,44,341,5890
E9788,67,64,43,76,91,341,5891
E5405,60,75,77,67,62,341,5892
E7375,64,45,77,61,94,341,5893
E3252,81,77,57,51,75,341,5894
E6844,69,50,50,79,93,341,5895
E8466,40,94,93,50,64,341,5896
E6286,62,81,74,79,45,341,5897
E6422,57,99,48,61,76,341,5898
E7184,70,70,68,71,62,341,5899
E9998,73,84,64,51,69,341,5900
E8638,75,63,47,59,97,341,5901
E4744,70,68,62,54,87,341,5902
E8231,91,56,47,82,65,341,5903
E7444,60,99,50,53,79,341,5904
E8232,97,49,66,63,66,341,5905
E2736,86,41,68,54,92,341,5906
E2298,65,77,41,64,94,341,5907
E7488,67,54,85,45,90,341,5908
E9016,89,77,88,47,40,341,5909
E3900,58,84,47,72,80,341,5910
E2065,46,95,85,53,62,341,5911
E2365,62,45,95,58,81,341,5912
E1794,49,45,82,67,98,341,5913
E8202,93,81,47,79,41,341,5914
E4758,60,76,60,95,50,341,5915
E2569,93,40,93,57,58,341,5916
E4433,85,65,40,69,82,341,5917
E2501,52,50,100,95,44,341,5918
E7208,61,77,61,92,50,341,5919
E8966,87,75,63,64,52,341,5920
E6875,85,75,68,44,69,341,5921
E4854,67,71,68,64,71,341,5922
E0001,59,75,74,45,88,341,5923
E0632,65,76,66,80,54,341,5924
E7977,93,64,47,82,55,341,5925
E2469,74,66,44,83,74,341,5926
E9244,86,45,78,63,69,341,5927
E8836,41,59,88,53,100,341,5928
E2366,48,56,92,84,61,341,5929
E4023,48,43,75,83,92,341,5930
E7832,73,76,60,79,53,341,5931
E3757,69,60,80,81,51,341,5932
E8513,99,55,71,42,74,341,5933
E9880,53,72,80,92,44,341,5934
E5996,86,54,41,98,62,341,5935
E2612,77,51,49,72,92,341,5936
E2040,47,92,48,74,80,341,5937
E3931,63,59,82,40,97,341,5938
E6125,91,42,49,76,83,341,5939
E4668,73,64,89,49,66,341,5940
E9933,79,55,42,78,87,341,5941
E2613,73,97,54,59,58,341,5942
E7120,64,54,86,46,91,341,5943
E6133,85,52,55,84,65,341,5944
E2374,46,99,60,65,71,341,5945
E0343,62,43,100,65,71,341,5946
E0307,50,85,64,48,94,341,5947
E5892,100,75,84,40,42,341,5948
E7034,55,74,66,68,78,341,5949
E0813,66,57,58,62,98,341,5950
E1800,43,80,78,57,83,341,5951
E0367,62,47,52,93,87,341,5952
E2634,69,55,58,98,61,341,5953
E0351,84,43,67,55,92,341,5954
E7110,76,57,93,75,40,341,5955
E3553,75,95,42,72,57,341,5956
E2202,56,74,83,48,80,341,5957
E4541,40,44,99,80,78,341,5958
E1532,92,82,41,77,49,341,5959
E8672,44,68,84,93,52,341,5960
E6207,72,99,61,40,69,341,5961
E4202,71,56,80,71,63,341,5962
E8318,58,68,66,69,80,341,5963
E5779,59,68,81,92,41,341,5964
E1266,48,90,57,99,47,341,5965
E1435,90,42,84,76,49,341,5966
E9283,62,79,75,64,61,341,5967
E4860,99,57,51,90,44,341,5968
E1095,66,87,40,68,80,341,5969
E0761,52,93,84,41,71,341,5970
E0075,50,80,61,52,98,341,5971
E4717,100,89,64,47,41,341,5972
E5468,89,43,41,81,87,341,5973
E3087,91,98,51,42,59,341,5974
E7646,92,58,55,79,57,341,5975
E3056,46,81,97,44,73,341,5976
E0448,50,46,97,82,66,341,5977
E3075,42,81,91,55,72,341,5978
E7716,47,41,92,100,61,341,5979
E1689,84,93,62,49,53,341,5980
E9875,53,94,62,40,92,341,5981
E7134,59,53,74,69,86,341,5982
E9204,44,54,72,99,72,341,5983
E2650,75,72,74,42,78,341,5984
E7146,75,70,73,65,58,341,5985
E7237,66,82,50,46,96,340,5986
E6496,57,94,61,50,78,340,5987
E1721,79,78,63,78,42,340,5988
E6488,80,70,83,46,61,340,5989
E0988,83,46,56,55,100,340,5990
E1121,62,51,54,90,83,340,5991
E6611,90,55,64,48,83,340,5992
E7950,82,48,74,54,82,340,5993
E2024,100,91,42,53,54,340,5994
E8614,41,100,57,59,83,340,5995
E1882,89,55,79,42,75,340,5996
E3072,70,43,73,80,74,340,5997
E1742,83,59,79,48,71,340,5998
E0140,51,87,99,57,46,340,5999
E5284,69,83,82,46,60,340,6000
E7275,45,88,79,61,67,340,6001
E3699,51,98,71,56,64,340,6002
E0133,44,67,89,66,74,340,6003
E1318,61,45,52,95,87,340,6004
E9552,68,54,62,85,71,340,6005
E4364,65,89,66,47,73,340,6006
E0306,74,48,51,70,97,340,6007
E8524,97,52,63,87,41,340,6008
E0426,77,47,70,68,78,340,6009
E3003,100,44,41,57,98,340,6010
E4067,55,52,76,94,63,340,6011
E2154,97,80,53,48,62,340,6012
E3665,72,84,57,82,45,340,6013
E7525,77,58,55,65,85,340,6014
E8489,47,68,94,88,43,340,6015
E8920,68,59,64,58,91,340,6016
E4986,69,84,52,86,49,340,6017
E1135,87,85,60,48,60,340,6018
E7720,88,43,40,75,94,340,6019
E3915,70,73,86,57,54,340,6020
E4835,61,87,73,56,63,340,6021
E0206,98,79,60,60,43,340,6022
E9050,65,89,79,58,49,340,6023
E3654,58,65,79,66,72,340,6024
E0549,48,52,45,97,98,340,6025
E0539,58,66,46,92,78,340,6026
E7817,94,45,52,55,94,340,6027
E8818,56,89,48,63,84,340,6028
E2372,73,62,67,96,42,340,6029
E7812,54,95,72,65,54,340,6030
E1526,66,76,98,56,44,340,6031
E9066,72,76,42,93,57,340,6032
E5393,54,69,56,76,85,340,6033
E3744,64,76,92,54,54,340,6034
E8419,50,57,54,80,99,340,6035
E6276,77,86,45,50,82,340,6036
E1570,86,43,49,78,84,340,6037
E3302,45,64,45,98,88,340,6038
E0593,50,78,61,97,54,340,6039
E1269,94,69,47,60,70,340,6040
E5465,46,91,47,76,80,340,6041
E6172,67,55,76,68,74,340,6042
E5106,82,62,78,47,71,340,6043
E7285,81,56,53,85,65,340,6044
E0775,56,98,67,51,68,340,6045
E9342,65,80,49,90,56,340,6046
E1803,67,45,81,82,65,340,6047
E4553,43,95,83,75,44,340,6048
E2344,82,63,82,56,57,340,6049
E6152,92,42,67,41,98,340,6050
E0187,81,60,90,47,62,340,6051
E1722,87,64,88,54,47,340,6052
E1998,76,51,92,52,69,340,6053
E5827,93,49,42,61,95,340,6054
E4180,44,83,78,66,69,340,6055
E5605,66,74,59,98,43,340,6056
E2939,55,51,67,98,69,340,6057
E7602,85,73,86,42,54,340,6058
E7702,84,48,41,86,81,340,6059
E6858,60,89,56,63,72,340,6060
E3299,55,69,81,49,86,340,6061
E2451,79,85,54,82,40,340,6062
E4573,44,88,52,56,100,340,6063
E6136,77,75,55,44,89,340,6064
E9811,64,61,72,98,45,340,6065
E1829,56,83,93,58,50,340,6066
E2937,65,100,58,52,65,340,6067
E5263,48,74,92,69,57,340,6068
E6502,57,76,56,51,100,340,6069
E7993,99,64,48,80,49,340,6070
E5055,80,90,49,41,80,340,6071
E0126,60,53,88,80,59,340,6072
E2520,43,58,78,98,63,340,6073
E3112,57,60,61,99,63,340,6074
E5374,45,89,76,50,80,340,6075
E4175,65,56,89,64,66,340,6076
E8263,89,73,58,43,77,340,6077
E3791,65,46,77,54,98,340,6078
E4157,47,53,51,92,97,340,6079
E9168,65,93,40,79,63,340,6080
E2779,57,64,87,82,50,340,6081
E9741,53,79,46,65,97,340,6082
E7191,69,78,70,66,57,340,6083
E8372,90,81,43,60,66,340,6084
E2439,65,62,90,56,67,340,6085
E2151,95,100,43,54,48,340,6086
E6141,46,88,90,43,73,340,6087
E2349,74,41,54,73,97,339,6088
E3041,99,79,43,60,58,339,6089
E1627,60,45,91,50,93,339,6090
E0019,59,76,96,61,47,339,6091
E7620,76,81,62,53,67,339,6092
E7160,53,89,55,78,64,339,6093
E7749,98,95,59,40,47,339,6094
E3403,42,66,83,57,91,339,6095
E7233,55,100,72,53,59,339,6096
E2433,79,51,67,62,80,339,6097
E2294,64,61,71,67,76,339,6098
E7314,70,50,78,78,63,339,6099
E8948,82,45,100,40,72,339,6100
E4922,59,84,81,64,51,339,6101
E6010,64,54,89,45,87,339,6102
E3186,44,46,84,92,73,339,6103
E1296,60,62,79,60,78,339,6104
E1091,54,84,81,75,45,339,6105
E9554,41,95,45,64,94,339,6106
E3716,70,42,81,55,91,339,6107
E5375,63,89,64,40,83,339,6108
E5639,74,40,88,69,68,339,6109
E3747,69,67,41,67,95,339,6110
E7487,85,44,63,99,48,339,6111
E6335,72,91,69,66,41,339,6112
E6448,98,41,50,82,68,339,6113
E1914,99,72,74,50,44,339,6114
E2702,74,73,69,44,79,339,6115
E1197,52,94,68,71,54,339,6116
E5112,49,73,41,94,82,339,6117
E2084,85,47,50,68,89,339,6118
E8664,61,86,92,58,42,339,6119
E5967,65,49,96,44,85,339,6120
E5713,71,68,50,57,93,339,6121
E2546,69,77,74,60,59,339,6122
E2536,61,45,68,80,85,339,6123
E3678,85,88,70,42,54,339,6124
E8837,81,68,49,66,75,339,6125
E3255,51,67,67,86,68,339,6126
E0232,80,88,69,41,61,339,6127
E3634,58,44,96,88,53,339,6128
E2197,52,78,74,93,42,339,6129
E8116,76,40,69,93,61,339,6130
E0218,98,42,46,89,64,339,6131
E5272,85,49,95,49,61,339,6132
E6665,61,72,99,62,45,339,6133
E6750,86,77,53,57,66,339,6134
E4571,52,79,98,55,55,339,6135
E6828,69,76,57,83,54,339,6136
E9101,61,64,95,48,71,339,6137
E0804,41,67,78,54,99,339,6138
E1230,50,87,61,49,92,339,6139
E9444,46,75,89,59,70,339,6140
E2519,44,85,83,62,65,339,6141
E6324,66,58,75,40,100,339,6142
E5479,76,57,54,63,89,339,6143
E8735,68,100,63,49,59,339,6144
E5833,64,68,40,72,95,339,6145
E5675,61,64,72,43,99,339,6146
E9111,43,81,67,53,95,339,6147
E3455,49,52,81,68,89,339,6148
E1999,45,96,55,69,74,339,6149
E7968,59,65,45,84,86,339,6150
E3952,80,84,45,89,41,339,6151
E5084,43,79,96,68,53,339,6152
E2799,77,46,64,52,100,339,6153
E7887,51,80,59,60,89,339,6154
E9318,90,55,64,42,88,339,6155
E6076,93,47,90,57,52,339,6156
E1369,86,51,79,60,63,339,6157
E1376,77,51,57,93,61,339,6158
E7765,60,69,44,70,96,339,6159
E6942,48,71,94,74,52,339,6160
E6095,75,70,41,60,93,339,6161
E7386,82,57,70,70,60,339,6162
E4053,71,94,53,60,61,339,6163
E9938,56,58,61,91,73,339,6164
E4518,78,51,56,85,69,339,6165
E1598,43,71,55,77,93,339,6166
E2233,68,43,76,88,64,339,6167
E9375,77,55,82,82,43,339,6168
E8806,51,86,77,60,65,339,6169
E0628,81,50,95,45,68,339,6170
E3249,86,44,73,47,89,339,6171
E9572,78,80,69,67,45,339,6172
E7943,52,86,66,52,83,339,6173
E0505,59,86,70,78,46,339,6174
E0443,64,48,88,88,51,339,6175
E0701,94,86,66,40,53,339,6176
E7874,67,48,70,77,77,339,6177
E9225,78,69,50,68,74,339,6178
E3925,89,52,100,43,55,339,6179
E7003,46,86,47,92,68,339,6180
E9965,66,58,55,84,75,338,6181
E5617,54,76,51,80,77,338,6182
E2565,67,44,63,84,80,338,6183
E7924,71,73,94,45,55,338,6184
E2380,94,52,53,95,44,338,6185
E2870,81,40,98,73,46,338,6186
E2721,44,63,89,93,49,338,6187
E5161,69,91,70,49,59,338,6188
E4725,52,41,73,91,81,338,6189
E6871,60,57,46,89,86,338,6190
E5488,55,57,52,99,75,338,6191
E4159,57,88,70,75,48,338,6192
E8977,49,48,75,80,86,338,6193
E6446,78,64,58,84,54,338,6194
E9187,66,60,44,73,95,338,6195
E9953,54,80,55,49,100,338,6196
E7282,66,73,72,46,81,338,6197
E0483,44,76,98,70,50,338,6198
E6159,49,53,100,92,44,338,6199
E0397,64,90,58,71,55,338,6200
E4566,54,76,68,65,75,338,6201
E6621,83,81,62,69,43,338,6202
E1817,69,100,43,43,83,338,6203
E5761,60,54,73,95,56,338,6204
E4198,54,99,66,65,54,338,6205
E1406,80,50,78,83,47,338,6206
E0455,50,55,67,74,92,338,6207
E2292,62,75,53,100,48,338,6208
E8785,89,68,47,78,56,338,6209
E7530,65,84,46,58,85,338,6210
E6259,40,65,72,100,61,338,6211
E0907,40,70,87,88,53,338,6212
E4500,74,61,45,92,66,338,6213
E3826,91,62,95,49,41,338,6214
E9042,67,89,86,47,49,338,6215
E9044,72,63,47,95,61,338,6216
E7937,49,79,91,72,47,338,6217
E4296,43,46,75,75,99,338,6218
E6595,62,52,79,64,81,338,6219
E5685,88,50,75,47,78,338,6220
E6248,93,78,70,48,49,338,6221
E6474,54,75,51,77,81,338,6222
E7180,61,86,68,78,45,338,6223
E4967,47,40,76,85,90,338,6224
E3278,77,51,60,61,89,338,6225
E4154,83,74,46,50,85,338,6226
E8994,71,54,80,46,87,338,6227
E8795,62,58,64,56,98,338,6228
E5355,52,90,61,70,65,338,6229
E9485,55,80,99,52,52,338,6230
E4347,69,56,60,95,58,338,6231
E1206,60,92,51,93,42,338,6232
E1964,49,73,49,79,88,338,6233
E9769,45,74,63,78,78,338,6234
E1011,93,49,91,53,52,338,6235
E9740,55,73,52,68,90,338,6236
E1404,46,91,42,65,94,338,6237
E2289,98,90,42,51,57,338,6238
E9222,53,90,100,41,54,338,6239
E7220,72,92,40,72,62,338,6240
E0909,58,88,59,89,44,338,6241
E2442,71,82,56,58,71,338,6242
E8710,55,84,82,63,54,338,6243
E4377,85,48,63,43,99,338,6244
E0210,68,42,71,90,67,338,6245
E4404,46,75,69,88,60,338,6246
E8381,64,63,77,43,91,338,6247
E3325,55,86,75,54,68,338,6248
E0843,66,89,55,82,46,338,6249
E9674,52,58,87,53,88,338,6250
E8855,49,86,100,58,45,338,6251
E9909,96,51,87,42,62,338,6252
E3661,73,81,45,68,71,338,6253
E4873,79,97,48,71,43,338,6254
E2624,48,81,73,86,50,338,6255
E7266,93,68,49,88,40,338,6256
E2837,54,70,66,85,63,338,6257
E8995,49,46,99,85,59,338,6258
E6697,95,40,53,70,80,338,6259
E1203,63,57,79,48,91,338,6260
E9702,40,89,63,89,57,338,6261
E8832,41,96,90,48,63,338,6262
E7037,40,91,64,88,55,338,6263
E0267,51,100,85,51,51,338,6264
E1844,65,43,49,98,83,338,6265
E4807,100,45,85,63,45,338,6266
E6865,75,41,44,98,80,338,6267
E6623,63,58,62,86,68,337,6268
E3401,46,66,61,73,91,337,6269
E6346,55,87,86,49,60,337,6270
E9416,68,42,96,62,69,337,6271
E0609,80,62,46,80,69,337,6272
E2156,59,60,51,87,80,337,6273
E4741,65,40,61,100,71,337,6274
E2907,55,85,68,74,55,337,6275
E3535,95,61,57,55,69,337,6276
E7138,76,58,46,78,79,337,6277
E9247,69,40,84,49,95,337,6278
E7764,49,49,86,87,66,337,6279
E7451,60,58,51,72,96,337,6280
E0291,53,73,95,44,72,337,6281
E0409,44,84,96,54,59,337,6282
E5720,72,40,82,59,84,337,6283
E9901,42,71,74,97,53,337,6284
E5692,57,59,100,78,43,337,6285
E1642,45,88,84,73,47,337,6286
E1098,99,68,67,61,42,337,6287
E7931,52,88,96,46,55,337,6288
E7130,48,87,43,80,79,337,6289
E8604,48,87,81,66,55,337,6290
E9540,78,88,62,68,41,337,6291
E7515,51,85,51,63,87,337,6292
E0578,45,72,80,64,76,337,6293
E1731,53,66,87,49,82,337,6294
E6673,58,94,45,70,70,337,6295
E6084,97,83,54,49,54,337,6296
E1631,52,44,89,96,56,337,6297
E3672,60,46,83,98,50,337,6298
E8644,84,55,91,62,45,337,6299
E0835,53,60,97,44,83,337,6300
E8089,55,61,66,80,75,337,6301
E0923,52,56,56,89,84,337,6302
E7297,45,49,77,94,72,337,6303
E2883,51,46,83,70,87,337,6304
E5823,51,91,73,59,63,337,6305
E8823,69,65,59,88,56,337,6306
E3076,60,40,77,71,89,337,6307
E5900,80,85,65,61,46,337,6308
E0892,53,77,71,94,42,337,6309
E4628,95,59,47,42,94,337,6310
E5776,73,93,54,53,64,337,6311
E7778,47,76,65,85,64,337,6312
E9734,74,71,100,51,41,337,6313
E3827,86,46,99,44,62,337,6314
E4802,42,89,42,88,76,337,6315
E9037,41,54,79,67,96,337,6316
E4025,54,58,47,85,93,337,6317
E2462,89,66,53,85,44,337,6318
E3271,58,57,83,50,89,337,6319
E6357,46,78,79,75,59,337,6320
E8723,63,52,89,84,49,337,6321
E3355,87,74,66,51,59,337,6322
E0935,99,44,48,80,66,337,6323
E3485,64,75,44,62,92,337,6324
E7502,51,99,63,57,67,337,6325
E5792,49,75,64,53,96,337,6326
E0354,66,42,99,64,66,337,6327
E2556,40,86,74,83,54,337,6328
E6341,54,45,44,97,97,337,6329
E1657,71,66,44,100,56,337,6330
E1438,56,76,88,40,77,337,6331
E4466,49,75,76,80,57,337,6332
E9471,53,69,88,48,79,337,6333
E5661,57,59,73,97,51,337,6334
E5383,45,93,62,97,40,337,6335
E9977,100,59,72,61,45,337,6336
E2965,66,89,46,96,40,337,6337
E6457,58,76,45,58,100,337,6338
E5739,74,83,65,42,73,337,6339
E4955,81,47,81,74,54,337,6340
E9462,86,64,43,75,69,337,6341
E3919,77,52,95,70,43,337,6342
E1481,58,97,44,71,67,337,6343
E5538,65,89,79,51,53,337,6344
E0069,99,73,49,45,71,337,6345
E5144,75,89,43,74,56,337,6346
E8390,97,40,44,93,63,337,6347
E9874,69,98,59,54,57,337,6348
E8420,69,87,68,63,50,337,6349
E3362,68,52,55,89,73,337,6350
E4633,44,71,57,81,84,337,6351
E0792,47,67,64,64,95,337,6352
E1028,63,75,56,47,96,337,6353
E9632,73,93,47,66,58,337,6354
E5377,67,49,61,88,72,337,6355
E8702,65,40,78,54,100,337,6356
E3297,52,90,94,41,60,337,6357
E8554,89,41,65,54,88,337,6358
E1951,48,98,85,40,66,337,6359
E7461,99,65,67,56,50,337,6360
E8389,61,82,61,68,65,337,6361
E2727,78,44,43,97,75,337,6362
E8607,92,65,78,49,53,337,6363
E0621,42,89,40,84,82,337,6364
E6016,45,74,48,75,95,337,6365
E4156,54,74,48,74,87,337,6366
E9248,83,57,83,72,42,337,6367
E7559,66,68,53,63,87,337,6368
E3819,57,76,70,89,45,337,6369
E9384,89,66,52,67,63,337,6370
E4345,47,75,100,46,69,337,6371
E7876,56,61,89,53,78,337,6372
E1696,42,70,71,60,94,337,6373
E7066,77,73,45,55,86,336,6374
E8130,84,44,80,42,86,336,6375
E4747,98,52,50,55,81,336,6376
E1767,60,73,45,67,91,336,6377
E9812,57,78,85,55,61,336,6378
E9722,58,67,60,65,86,336,6379
E8211,79,45,51,97,64,336,6380
E0989,95,56,60,54,71,336,6381
E9102,100,49,86,61,40,336,6382
E7372,59,81,40,74,82,336,6383
E4836,88,62,50,69,67,336,6384
E6956,58,72,58,66,82,336,6385
E5610,60,93,64,49,70,336,6386
E7330,63,95,85,51,42,336,6387
E2756,45,72,92,45,82,336,6388
E5602,47,88,64,49,88,336,6389
E4299,42,50,100,75,69,336,6390
E6949,51,52,96,42,95,336,6391
E8266,79,47,41,95,74,336,6392
E2086,84,76,57,65,54,336,6393
E3869,53,81,89,58,55,336,6394
E5245,44,68,82,56,86,336,6395
E6182,44,94,96,43,59,336,6396
E6322,67,58,50,92,69,336,6397
E6809,95,52,54,83,52,336,6398
E8671,90,45,80,69,52,336,6399
E5324,55,58,55,86,82,336,6400
E6560,77,83,76,43,57,336,6401
E9188,87,93,48,62,46,336,6402
E4940,76,48,77,66,69,336,6403
E5108,67,90,50,74,55,336,6404
E1760,48,62,50,78,98,336,6405
E8376,74,61,58,65,78,336,6406
E0425,82,62,79,69,44,336,6407
E9365,88,55,53,44,96,336,6408
E5865,46,47,56,89,98,336,6409
E6556,88,92,51,50,55,336,6410
E2792,52,72,70,42,100,336,6411
E7279,43,93,84,74,42,336,6412
E2646,85,59,49,73,70,336,6413
E1083,63,86,65,58,64,336,6414
E4976,63,49,56,89,79,336,6415
E3865,45,98,62,54,77,336,6416
E4547,70,96,47,77,46,336,6417
E0170,55,63,76,57,85,336,6418
E5810,80,77,41,87,51,336,6419
E5462,84,47,46,98,61,336,6420
E0820,90,58,45,99,44,336,6421
E7614,82,92,50,51,61,336,6422
E3523,86,55,75,51,69,336,6423
E4102,85,52,62,54,83,336,6424
E9280,81,59,44,97,55,336,6425
E6434,85,59,83,67,42,336,6426
E0875,75,48,74,91,48,336,6427
E0827,98,57,66,57,58,336,6428
E1041,93,69,67,55,52,336,6429
E9271,48,86,48,54,100,336,6430
E7337,42,88,86,49,71,336,6431
E3371,67,84,49,49,87,336,6432
E4109,71,77,69,53,66,336,6433
E8338,50,70,60,92,64,336,6434
E7300,76,46,52,97,65,336,6435
E9990,81,41,74,72,68,336,6436
E7889,70,83,43,47,93,336,6437
E0908,73,85,43,43,92,336,6438
E9856,85,55,82,69,45,336,6439
E9944,61,49,77,68,81,336,6440
E9213,58,88,63,46,81,336,6441
E2173,83,47,77,47,82,336,6442
E0087,67,47,91,78,53,336,6443
E1324,83,62,52,50,89,336,6444
E3680,73,55,86,51,71,336,6445
E4278,92,72,67,60,45,336,6446
E9354,67,82,63,62,62,336,6447
E9917,42,84,64,91,55,336,6448
E3582,45,54,93,50,94,336,6449
E3863,63,93,66,69,45,336,6450
E6945,79,62,49,63,83,336,6451
E9124,59,98,72,65,42,336,6452
E8852,64,82,68,77,45,336,6453
E8142,68,77,53,65,73,336,6454
E5736,62,58,73,82,61,336,6455
E8653,62,88,77,65,44,336,6456
E7501,81,65,73,43,74,336,6457
E8344,84,99,42,71,40,336,6458
E8976,52,83,74,46,81,336,6459
E0024,85,47,74,55,75,336,6460
E8018,70,47,91,73,55,336,6461
E3978,73,61,78,54,70,336,6462
E9459,75,83,78,41,59,336,6463
E7607,68,94,43,84,47,336,6464
E8624,80,51,90,64,51,336,6465
E0421,41,77,85,61,72,336,6466
E8957,57,88,41,94,56,336,6467
E1655,95,47,75,67,52,336,6468
E3436,65,78,89,51,53,336,6469
E8754,70,80,55,65,65,335,6470
E1471,57,97,62,63,56,335,6471
E3713,61,81,59,52,82,335,6472
E8281,97,43,58,58,79,335,6473
E4286,41,72,51,90,81,335,6474
E8923,65,46,97,61,66,335,6475
E3552,45,57,73,73,87,335,6476
E2199,89,57,60,66,63,335,6477
E3309,92,68,66,61,48,335,6478
E8410,59,93,87,45,51,335,6479
E7424,46,84,64,100,41,335,6480
E3002,75,56,56,88,60,335,6481
E7603,44,72,69,98,52,335,6482
E1118,76,73,77,51,58,335,6483
E6720,63,77,63,64,68,335,6484
E7485,62,86,56,82,49,335,6485
E7548,51,49,80,68,87,335,6486
E6440,81,72,53,47,82,335,6487
E9983,76,79,62,64,54,335,6488
E2857,55,88,88,51,53,335,6489
E1461,92,63,84,49,47,335,6490
E4743,62,60,94,64,55,335,6491
E0487,52,57,91,71,64,335,6492
E4335,64,65,56,65,85,335,6493
E7035,51,63,99,70,52,335,6494
E5915,82,89,60,45,59,335,6495
E8401,67,69,81,53,65,335,6496
E8022,45,82,91,69,48,335,6497
E7069,89,65,71,55,55,335,6498
E9008,69,51,78,77,60,335,6499
E3528,59,84,44,69,79,335,6500
E8572,41,92,48,92,62,335,6501
E3629,63,76,63,82,51,335,6502
E8588,68,85,40,82,60,335,6503
E5510,40,85,77,58,75,335,6504
E3709,90,54,59,55,77,335,6505
E9808,88,65,91,51,40,335,6506
E5338,51,91,72,44,77,335,6507
E6264,54,45,92,89,55,335,6508
E0372,56,75,63,95,46,335,6509
E3765,51,90,41,88,65,335,6510
E9686,74,42,66,99,54,335,6511
E4193,61,78,48,93,55,335,6512
E7366,42,77,93,44,79,335,6513
E3001,59,81,72,70,53,335,6514
E4680,60,45,90,84,56,335,6515
E2011,100,51,41,46,97,335,6516
E1348,100,62,40,43,90,335,6517
E8393,56,69,94,69,47,335,6518
E3817,70,84,44,62,75,335,6519
E4740,87,86,46,55,61,335,6520
E7884,53,69,98,64,51,335,6521
E9205,69,88,54,68,56,335,6522
E6826,50,74,64,76,71,335,6523
E0957,44,85,63,92,51,335,6524
E9313,100,59,40,50,86,335,6525
E7152,73,61,72,84,45,335,6526
E4893,53,74,50,70,88,335,6527
E8961,85,74,60,47,69,335,6528
E0824,53,70,87,42,83,335,6529
E3493,43,88,65,52,87,335,6530
E3007,72,50,89,77,47,335,6531
E8147,59,67,71,98,40,335,6532
E4590,46,59,99,57,74,335,6533
E6934,46,73,40,81,95,335,6534
E8282,83,56,43,74,79,335,6535
E1940,41,79,65,90,60,335,6536
E1288,44,66,88,47,90,335,6537
E3142,56,48,44,87,100,335,6538
E2428,49,74,84,77,51,335,6539
E2637,47,98,69,62,59,335,6540
E0377,58,73,55,78,71,335,6541
E9764,40,41,100,70,84,335,6542
E5596,69,84,44,90,48,335,6543
E3476,63,72,52,97,51,335,6544
E3157,48,60,68,73,86,335,6545
E6692,58,84,49,95,49,335,6546
E1853,48,63,54,90,80,335,6547
E5769,41,79,66,50,99,335,6548
E9250,97,76,56,58,48,335,6549
E3433,43,70,86,62,74,335,6550
E4122,72,65,55,76,67,335,6551
E2073,82,58,66,41,88,335,6552
E5064,46,87,62,80,59,334,6553
E5133,85,57,72,48,72,334,6554
E0984,61,40,76,70,87,334,6555
E7128,71,93,76,43,51,334,6556
E1047,42,59,79,69,85,334,6557
E2499,54,61,80,78,61,334,6558
E0461,93,80,40,60,61,334,6559
E4696,63,65,72,94,40,334,6560
E9185,49,58,82,95,50,334,6561
E8581,95,46,84,45,64,334,6562
E8872,78,54,74,53,75,334,6563
E6876,78,83,47,56,70,334,6564
E9156,96,68,75,44,51,334,6565
E3882,92,44,48,66,84,334,6566
E9137,59,88,62,84,41,334,6567
E1886,85,72,62,64,51,334,6568
E9816,67,50,88,55,74,334,6569
E9396,74,76,41,84,59,334,6570
E0826,90,88,46,63,47,334,6571
E9833,73,74,73,61,53,334,6572
E5557,66,86,47,86,49,334,6573
E8224,95,48,41,51,99,334,6574
E7944,48,52,100,61,73,334,6575
E4086,93,61,48,79,53,334,6576
E0663,74,51,64,85,60,334,6577
E5520,80,55,89,40,70,334,6578
E9321,76,58,77,63,60,334,6579
E8461,72,57,73,65,67,334,6580
E2028,68,96,55,43,72,334,6581
E4151,59,58,87,89,41,334,6582
E8892,93,46,74,77,44,334,6583
E8564,50,83,41,96,64,334,6584
E2235,86,45,47,68,88,334,6585
E9262,65,40,100,58,71,334,6586
E0201,52,60,88,70,64,334,6587
E3149,41,76,81,90,46,334,6588
E8964,48,68,60,60,98,334,6589
E6255,54,81,60,60,79,334,6590
E0252,84,79,66,62,43,334,6591
E7867,50,67,77,62,78,334,6592
E4649,73,97,52,48,64,334,6593
E4380,75,44,54,61,100,334,6594
E5786,88,44,50,84,68,334,6595
E4938,88,45,80,49,72,334,6596
E0983,45,85,87,50,67,334,6597
E0200,99,74,67,47,47,334,6598
E3177,84,60,50,58,82,334,6599
E5184,42,68,86,87,51,334,6600
E7829,62,77,50,64,81,334,6601
E3603,83,54,61,95,41,334,6602
E9081,66,68,47,82,71,334,6603
E4365,63,70,81,80,40,334,6604
E7612,51,42,89,85,67,334,6605
E5085,94,56,44,40,100,334,6606
E5588,84,51,64,87,48,334,6607
E3851,93,57,70,41,73,334,6608
E0362,63,73,63,60,75,334,6609
E6800,93,42,74,74,51,334,6610
E4806,81,95,43,75,40,334,6611
E0203,59,95,87,49,44,334,6612
E8713,50,61,75,89,59,334,6613
E0436,72,58,69,59,76,334,6614
E0132,51,88,49,68,78,334,6615
E4655,80,92,66,41,55,334,6616
E2588,93,59,43,90,49,334,6617
E8983,54,62,82,88,48,334,6618
E1505,62,87,42,68,75,334,6619
E6628,46,68,68,97,55,334,6620
E7503,49,99,52,87,47,334,6621
E6254,90,62,55,74,53,334,6622
E6313,82,86,76,43,47,334,6623
E6471,85,56,77,57,59,334,6624
E3561,71,93,86,43,41,334,6625
E6342,61,89,66,68,50,334,6626
E2328,62,68,54,96,54,334,6627
E7229,81,62,66,52,73,334,6628
E1620,68,49,85,86,46,334,6629
E2189,74,51,79,42,88,334,6630
E3053,75,76,67,49,67,334,6631
E6212,48,64,59,70,93,334,6632
E2705,40,42,93,65,94,334,6633
E1698,83,42,98,63,48,334,6634
E4056,72,97,43,82,40,334,6635
E7262,59,82,58,62,73,334,6636
E1729,77,66,88,56,47,334,6637
E1063,43,72,77,85,57,334,6638
E0300,54,90,46,99,45,334,6639
E4768,69,80,76,40,69,334,6640
E6032,100,50,60,61,63,334,6641
E0643,69,65,51,73,76,334,6642
E3096,83,55,82,72,42,334,6643
E6843,46,49,78,100,61,334,6644
E3404,100,62,58,68,46,334,6645
E4166,64,51,94,77,48,334,6646
E5870,99,51,96,40,48,334,6647
E1753,60,88,44,74,68,334,6648
E5640,76,43,80,74,60,333,6649
E3353,59,80,49,71,74,333,6650
E4642,95,57,44,48,89,333,6651
E6435,47,81,78,86,41,333,6652
E1000,47,75,52,98,61,333,6653
E1441,61,96,58,52,66,333,6654
E9173,71,59,41,88,74,333,6655
E9961,91,55,68,77,42,333,6656
E1390,65,71,58,66,73,333,6657
E9123,69,42,52,91,79,333,6658
E8793,83,82,41,57,70,333,6659
E2691,78,52,62,47,94,333,6660
E3416,44,56,91,59,83,333,6661
E0893,56,51,44,93,89,333,6662
E7311,59,96,55,41,82,333,6663
E2293,93,85,70,44,41,333,6664
E2494,54,87,49,54,89,333,6665
E0791,67,52,75,45,94,333,6666
E8645,97,48,63,76,49,333,6667
E3988,93,46,73,53,68,333,6668
E4638,76,62,62,70,63,333,6669
E0020,53,81,65,56,78,333,6670
E4463,53,60,71,53,96,333,6671
E1280,43,86,96,64,44,333,6672
E2968,58,60,58,71,86,333,6673
E8317,71,60,66,65,71,333,6674
E4996,65,48,92,59,69,333,6675
E8416,93,84,70,40,46,333,6676
E2936,66,57,50,63,97,333,6677
E5930,70,59,86,48,70,333,6678
E0637,75,82,66,59,51,333,6679
E0736,90,59,76,55,53,333,6680
E4640,75,76,57,51,74,333,6681
E2061,68,67,46,78,74,333,6682
E7712,47,74,63,52,97,333,6683
E9780,44,70,46,89,84,333,6684
E5437,40,99,97,55,42,333,6685
E5551,70,72,78,56,57,333,6686
E6891,82,64,48,95,44,333,6687
E6147,90,87,40,64,52,333,6688
E8718,48,50,74,79,82,333,6689
E4469,94,44,53,71,71,333,6690
E9333,69,64,48,52,100,333,6691
E4373,56,56,51,88,82,333,6692
E8896,58,83,40,80,72,333,6693
E6923,63,90,61,60,59,333,6694
E4089,47,96,53,60,77,333,6695
E9255,93,70,52,56,62,333,6696
E9385,61,58,40,88,86,333,6697
E9431,42,55,96,48,92,333,6698
E1585,72,80,82,50,49,333,6699
E3960,84,69,54,79,47,333,6700
E4284,89,89,42,56,57,333,6701
E7731,56,94,87,45,51,333,6702
E6392,57,50,59,85,82,333,6703
E2566,43,63,85,66,76,333,6704
E1825,69,82,50,69,63,333,6705
E1182,42,58,81,75,77,333,6706
E7080,50,44,76,80,83,333,6707
E1090,54,45,77,77,80,333,6708
E4820,80,100,46,53,54,333,6709
E9857,67,71,43,100,52,333,6710
E4632,85,72,60,65,51,333,6711
E1874,51,62,93,85,42,333,6712
E5991,97,49,71,40,76,333,6713
E8704,67,53,62,92,59,333,6714
E7471,79,42,41,99,72,333,6715
E0891,69,57,78,80,49,333,6716
E0059,50,77,79,58,69,333,6717
E9893,53,75,67,96,42,333,6718
E6056,65,79,80,68,41,333,6719
E7415,54,90,66,42,81,333,6720
E9633,68,41,54,95,75,333,6721
E2878,51,95,43,72,72,333,6722
E8464,63,72,56,65,77,333,6723
E4449,78,64,59,60,72,333,6724
E1331,96,48,49,64,76,333,6725
E4949,63,41,77,96,56,333,6726
E5791,81,92,66,42,52,333,6727
E5048,90,48,64,77,54,333,6728
E6437,50,64,90,52,77,333,6729
E6469,82,57,59,91,44,333,6730
E2404,65,83,80,63,42,333,6731
E1545,63,64,84,46,76,333,6732
E7096,52,71,77,59,74,333,6733
E3199,42,57,84,72,77,332,6734
E0725,49,44,99,87,53,332,6735
E0221,46,45,68,95,78,332,6736
E8938,63,92,44,56,77,332,6737
E9487,54,41,60,98,79,332,6738
E9641,43,50,73,96,70,332,6739
E9433,80,96,47,45,64,332,6740
E5332,89,53,52,66,72,332,6741
E5851,51,64,42,100,75,332,6742
E9089,41,83,55,87,66,332,6743
E5137,53,44,73,87,75,332,6744
E6796,64,78,44,77,69,332,6745
E1259,45,72,96,71,48,332,6746
E2285,61,54,94,82,41,332,6747
E7071,44,60,97,43,88,332,6748
E2840,57,99,49,87,40,332,6749
E8291,70,57,84,56,65,332,6750
E1075,44,67,94,52,75,332,6751
E8450,46,70,48,74,94,332,6752
E3794,78,52,45,82,75,332,6753
E5318,53,61,59,83,76,332,6754
E3211,47,49,57,87,92,332,6755
E6840,67,54,81,56,74,332,6756
E9294,72,66,44,53,97,332,6757
E8569,63,69,98,46,56,332,6758
E3663,76,71,58,68,59,332,6759
E3894,85,47,64,70,66,332,6760
E0730,50,89,77,49,67,332,6761
E4557,90,48,67,61,66,332,6762
E2694,62,93,54,82,41,332,6763
E6085,74,84,42,74,58,332,6764
E1114,46,68,98,74,46,332,6765
E1004,55,90,41,61,85,332,6766
E3834,99,60,76,46,51,332,6767
E0384,88,91,52,54,47,332,6768
E7371,46,92,78,72,44,332,6769
E6781,89,63,55,54,71,332,6770
E4708,44,69,65,95,59,332,6771
E0963,95,52,52,83,50,332,6772
E7090,60,49,73,81,69,332,6773
E0901,44,93,51,53,91,332,6774
E2704,61,82,56,42,91,332,6775
E8292,88,42,55,73,74,332,6776
E0485,73,46,55,90,68,332,6777
E8327,84,42,60,72,74,332,6778
E7272,62,74,67,79,50,332,6779
E9601,47,48,89,76,72,332,6780
E7014,65,76,54,87,50,332,6781
E7401,93,50,50,99,40,332,6782
E0589,46,65,80,46,95,332,6783
E7360,83,42,50,88,69,332,6784
E4386,52,82,78,62,58,332,6785
E8928,49,58,72,58,95,332,6786
E2490,78,63,58,71,62,332,6787
E3555,77,80,71,59,45,332,6788
E7479,72,92,66,48,54,332,6789
E7173,93,51,78,47,63,332,6790
E7267,84,81,67,53,47,332,6791
E7041,96,45,42,54,95,332,6792
E8190,77,46,59,62,88,332,6793
E5980,71,79,54,50,78,332,6794
E8427,76,44,46,92,74,332,6795
E3035,78,70,59,53,72,332,6796
E4596,59,81,52,72,68,332,6797
E4257,79,60,62,91,40,332,6798
E0171,97,94,51,46,44,332,6799
E8593,40,44,76,94,78,332,6800
E2116,42,94,68,67,61,332,6801
E0577,83,66,42,53,88,332,6802
E9821,57,74,42,89,70,332,6803
E3941,46,53,80,53,100,332,6804
E7583,84,49,65,52,82,332,6805
E8358,49,94,53,81,55,332,6806
E3080,97,75,59,41,60,332,6807
E5571,54,43,82,69,84,332,6808
E5977,65,50,80,62,75,332,6809
E9327,62,69,81,65,55,332,6810
E9546,87,45,76,81,43,332,6811
E0061,54,45,72,85,76,332,6812
E3595,70,85,63,54,60,332,6813
E4797,79,48,56,56,93,332,6814
E4371,61,44,67,91,69,332,6815
E6042,78,45,67,64,78,332,6816
E1025,51,59,65,83,74,332,6817
E0944,41,83,41,80,87,332,6818
E7547,79,49,81,83,40,332,6819
E4870,85,93,52,58,44,332,6820
E6717,62,49,85,44,91,331,6821
E8517,80,66,78,49,58,331,6822
E9651,42,47,96,87,59,331,6823
E4420,86,92,44,47,62,331,6824
E7359,47,91,57,93,43,331,6825
E2593,44,69,67,93,58,331,6826
E0595,41,72,86,47,85,331,6827
E1401,40,81,74,63,73,331,6828
E1685,85,96,46,45,59,331,6829
E8032,73,59,63,89,47,331,6830
E8319,51,88,98,51,43,331,6831
E9135,66,47,88,81,49,331,6832
E9532,76,56,94,60,45,331,6833
E0618,40,64,71,71,85,331,6834
E8445,64,43,47,81,96,331,6835
E3693,55,80,55,95,46,331,6836
E4891,58,91,57,67,58,331,6837
E8121,81,58,45,58,89,331,6838
E8760,47,45,95,49,95,331,6839
E1384,82,87,78,42,42,331,6840
E8308,67,59,79,73,53,331,6841
E6716,48,92,43,50,98,331,6842
E1405,55,43,87,64,82,331,6843
E1304,80,73,43,87,48,331,6844
E6978,41,67,68,66,89,331,6845
E6731,43,82,91,70,45,331,6846
E6009,55,57,81,46,92,331,6847
E9669,73,92,54,67,45,331,6848
E5679,87,41,100,62,41,331,6849
E1892,66,77,77,41,70,331,6850
E2085,42,60,70,87,72,331,6851
E3548,71,54,58,94,54,331,6852
E3675,96,57,74,57,47,331,6853
E1716,96,72,47,53,63,331,6854
E3957,67,76,70,42,76,331,6855
E0125,71,58,60,47,95,331,6856
E8428,55,86,81,47,62,331,6857
E5480,47,100,50,55,79,331,6858
E2949,47,83,65,58,78,331,6859
E1899,79,40,86,53,73,331,6860
E7730,78,62,97,44,50,331,6861
E3551,90,42,50,66,83,331,6862
E3217,61,60,50,90,70,331,6863
E3180,91,49,65,59,67,331,6864
E0606,79,86,48,71,47,331,6865
E2219,49,84,96,52,50,331,6866
E7965,68,61,70,81,51,331,6867
E2744,63,87,67,54,60,331,6868
E2200,69,72,57,42,91,331,6869
E2377,91,66,62,70,42,331,6870
E8105,54,69,76,58,74,331,6871
E2456,73,99,64,55,40,331,6872
E4152,73,75,50,63,70,331,6873
E2628,57,79,46,81,68,331,6874
E2278,93,61,71,48,58,331,6875
E3396,86,51,81,55,58,331,6876
E3152,98,65,51,68,49,331,6877
E4040,45,46,97,90,53,331,6878
E6922,59,40,83,62,87,331,6879
E3218,71,65,97,41,57,331,6880
E4714,48,63,65,97,58,331,6881
E7652,92,76,49,40,74,331,6882
E1680,57,53,52,73,96,331,6883
E3378,67,79,77,55,53,331,6884
E6980,64,84,47,49,87,331,6885
E3386,45,97,44,49,96,331,6886
E6724,70,96,44,64,57,331,6887
E6382,66,92,55,66,52,331,6888
E7776,93,63,66,55,54,331,6889
E2481,54,96,67,72,42,331,6890
E1459,55,92,97,41,46,331,6891
E2104,75,89,54,48,65,331,6892
E9012,86,48,52,81,64,331,6893
E9292,47,72,45,83,84,331,6894
E8611,40,63,90,79,59,331,6895
E2486,65,49,82,51,84,331,6896
E1573,72,85,60,69,45,331,6897
E6323,41,76,43,90,81,331,6898
E9677,46,70,61,89,65,331,6899
E8431,60,91,45,50,85,331,6900
E1612,52,88,72,68,51,331,6901
E5511,42,87,77,73,52,331,6902
E3829,50,92,43,93,53,331,6903
E3427,99,46,57,84,45,331,6904
E4007,55,66,64,93,53,331,6905
E2012,52,74,55,77,73,331,6906
E0511,41,40,95,85,70,331,6907
E9615,66,92,56,73,44,331,6908
E6108,45,63,54,96,73,331,6909
E9941,66,56,75,84,50,331,6910
E5121,68,87,79,40,57,331,6911
E7265,87,75,59,56,54,331,6912
E3011,73,54,75,84,45,331,6913
E8884,73,71,61,64,62,331,6914
E6000,92,52,43,54,90,331,6915
E9683,43,76,81,58,73,331,6916
E6660,87,67,45,61,71,331,6917
E7284,53,80,86,42,69,330,6918
E1932,41,60,58,80,91,330,6919
E4274,100,42,47,55,86,330,6920
E1713,65,42,77,59,87,330,6921
E6892,41,99,90,54,46,330,6922
E4125,79,74,77,49,51,330,6923
E5242,93,60,84,46,47,330,6924
E9800,53,62,74,93,48,330,6925
E0135,92,42,50,73,73,330,6926
E7917,70,68,61,54,77,330,6927
E9472,63,83,66,76,42,330,6928
E6183,48,82,76,59,65,330,6929
E1159,79,86,82,43,40,330,6930
E8384,48,87,52,66,77,330,6931
E8204,60,83,80,49,58,330,6932
E2801,46,89,70,74,51,330,6933
E1832,69,83,48,54,76,330,6934
E5934,48,80,52,76,74,330,6935
E0947,47,67,75,71,70,330,6936
E1423,69,54,71,57,79,330,6937
E9852,83,43,57,91,56,330,6938
E4944,85,78,62,53,52,330,6939
E3736,54,82,76,49,69,330,6940
E3287,52,95,62,76,45,330,6941
E6102,79,55,62,83,51,330,6942
E7542,40,63,86,86,55,330,6943
E9025,49,92,92,53,44,330,6944
E1032,53,59,85,65,68,330,6945
E1012,97,60,42,69,62,330,6946
E0015,72,69,53,90,46,330,6947
E0419,49,70,77,59,75,330,6948
E0496,43,96,65,73,53,330,6949
E1522,61,51,95,71,52,330,6950
E3099,78,70,79,48,55,330,6951
E5100,95,53,41,53,88,330,6952
E2032,100,49,48,87,46,330,6953
E7306,81,46,47,94,62,330,6954
E9813,65,88,81,49,47,330,6955
E1123,91,44,61,82,52,330,6956
E7025,93,61,42,84,50,330,6957
E2070,63,69,52,100,46,330,6958
E6285,66,74,63,47,80,330,6959
E4728,99,42,90,48,51,330,6960
E2587,64,84,59,47,76,330,6961
E1434,54,84,56,44,92,330,6962
E4280,60,57,56,90,67,330,6963
E4961,51,60,84,63,72,330,6964
E7274,57,70,68,45,90,330,6965
E9118,64,60,69,68,69,330,6966
E9966,88,40,40,76,86,330,6967
E5595,82,46,100,49,53,330,6968
E5410,93,89,44,50,54,330,6969
E1672,42,100,83,47,58,330,6970
E5232,53,46,70,66,95,330,6971
E4005,84,56,52,89,49,330,6972
E0413,65,63,84,61,57,330,6973
E1415,66,49,56,75,84,330,6974
E7111,49,44,72,77,88,330,6975
E3888,73,81,55,63,58,330,6976
E6321,80,68,47,43,92,330,6977
E1771,72,64,43,60,91,330,6978
E4111,71,56,51,69,83,330,6979
E3093,88,65,59,51,67,330,6980
E0139,60,83,73,50,64,330,6981
E2172,40,70,48,99,73,330,6982
E4354,79,42,84,43,82,330,6983
E0488,51,64,44,84,87,330,6984
E3418,92,45,87,49,57,330,6985
E4537,62,53,54,69,92,330,6986
E6588,63,73,49,86,59,330,6987
E4513,80,49,60,48,93,330,6988
E6506,67,71,63,77,52,330,6989
E8963,56,55,73,90,56,330,6990
E8665,56,86,76,72,40,330,6991
E4604,76,83,61,51,59,330,6992
E1707,47,64,83,55,81,330,6993
E2313,80,65,41,77,67,330,6994
E8503,68,50,63,96,53,330,6995
E6598,54,57,80,52,87,330,6996
E8642,95,54,57,63,61,330,6997
E2759,64,47,67,89,63,330,6998
E4211,86,72,44,43,84,329,6999
E6119,79,79,43,83,45,329,7000
E5633,93,45,44,83,64,329,7001
E4585,65,41,85,52,86,329,7002
E0146,70,52,69,83,55,329,7003
E7946,86,42,59,99,43,329,7004
E0478,55,53,98,56,67,329,7005
E0633,91,42,67,64,65,329,7006
E3674,81,53,59,79,57,329,7007
E4452,42,59,66,66,96,329,7008
E3071,66,46,58,68,91,329,7009
E2183,40,79,56,97,57,329,7010
E4618,61,62,99,66,41,329,7011
E6656,61,61,73,68,66,329,7012
E1987,50,67,54,89,69,329,7013
E3202,83,75,68,43,60,329,7014
E9698,66,46,67,93,57,329,7015
E0964,76,46,88,78,41,329,7016
E5638,67,60,70,43,89,329,7017
E9229,58,57,73,73,68,329,7018
E0629,79,79,49,65,57,329,7019
E7368,63,78,46,72,70,329,7020
E5379,59,72,49,86,63,329,7021
E9017,77,100,46,41,65,329,7022
E0121,55,55,63,95,61,329,7023
E2814,64,96,49,79,41,329,7024
E9355,90,41,84,74,40,329,7025
E2898,73,57,65,54,80,329,7026
E8914,55,61,69,56,88,329,7027
E0831,40,92,93,54,50,329,7028
E5724,51,52,67,98,61,329,7029
E7651,88,88,64,47,42,329,7030
E2843,90,61,44,63,71,329,7031
E7463,59,60,42,83,85,329,7032
E3045,78,98,45,61,47,329,7033
E9455,91,55,49,45,89,329,7034
E5326,91,47,59,82,50,329,7035
E8839,93,57,85,45,49,329,7036
E2685,70,70,57,79,53,329,7037
E1770,81,41,50,62,95,329,7038
E4003,65,79,62,71,52,329,7039
E5957,65,80,64,54,66,329,7040
E6583,60,92,94,42,41,329,7041
E8565,50,55,81,60,83,329,7042
E9818,72,55,66,90,46,329,7043
E8194,44,43,88,75,79,329,7044
E2182,82,56,51,82,58,329,7045
E3687,45,71,63,79,71,329,7046
E8180,59,48,87,71,64,329,7047
E6157,53,87,52,96,41,329,7048
E4470,66,44,92,57,70,329,7049
E8470,48,52,56,98,75,329,7050
E2947,60,79,64,69,57,329,7051
E5032,75,66,95,49,44,329,7052
E6925,97,75,64,52,41,329,7053
E9029,83,53,70,70,53,329,7054
E7890,86,69,86,45,43,329,7055
E0239,68,77,44,48,92,329,7056
E6201,69,71,92,44,53,329,7057
E0836,76,67,40,72,74,329,7058
E3231,59,58,79,68,65,329,7059
E7277,74,98,42,74,41,329,7060
E3319,69,67,51,62,80,329,7061
E3697,41,87,53,95,53,329,7062
E2179,84,44,74,73,54,329,7063
E9609,62,73,49,75,70,329,7064
E9252,60,86,43,69,71,329,7065
E0352,40,83,86,43,77,329,7066
E8003,53,97,80,52,47,329,7067
E1614,65,52,75,51,85,328,7068
E3541,57,59,70,83,59,328,7069
E7752,77,59,73,68,51,328,7070
E3556,40,81,98,49,60,328,7071
E0949,68,94,63,60,43,328,7072
E1129,79,43,74,49,83,328,7073
E8354,79,61,83,44,61,328,7074
E4088,41,56,85,74,72,328,7075
E5486,84,47,50,85,62,328,7076
E2772,46,47,100,86,49,328,7077
E1341,66,88,50,41,83,328,7078
E3965,55,86,89,56,42,328,7079
E0786,46,74,80,41,87,328,7080
E6782,55,50,88,84,51,328,7081
E7770,71,75,44,75,63,328,7082
E5687,53,41,84,65,85,328,7083
E6739,49,91,58,53,77,328,7084
E9298,65,79,97,43,44,328,7085
E7526,66,76,65,74,47,328,7086
E9400,86,62,43,77,60,328,7087
E9618,54,98,51,67,58,328,7088
E1990,93,55,62,57,61,328,7089
E5208,72,81,86,44,45,328,7090
E0698,54,87,78,60,49,328,7091
E0246,63,50,50,80,85,328,7092
E8606,97,46,49,62,74,328,7093
E4396,50,44,94,47,93,328,7094
E9103,78,99,45,50,56,328,7095
E9394,58,56,86,41,87,328,7096
E7820,54,85,83,65,41,328,7097
E2457,88,83,49,43,65,328,7098
E6769,68,40,81,75,64,328,7099
E7065,98,64,47,55,64,328,7100
E3810,70,55,80,53,70,328,7101
E5788,70,49,81,72,56,328,7102
E9129,73,47,79,75,54,328,7103
E3706,51,88,53,62,74,328,7104
E3676,68,58,43,72,87,328,7105
E4415,58,91,46,90,43,328,7106
E0651,45,51,65,89,78,328,7107
E4793,54,82,92,60,40,328,7108
E2017,47,93,91,49,48,328,7109
E2290,78,50,66,72,62,328,7110
E1687,73,95,49,43,68,328,7111
E3037,62,67,61,88,50,328,7112
E6636,47,99,54,44,84,328,7113
E0708,58,81,74,48,67,328,7114
E6563,64,61,52,62,89,328,7115
E9603,44,88,42,80,74,328,7116
E2880,91,53,62,60,62,328,7117
E9910,90,41,54,91,52,328,7118
E3446,43,90,62,54,79,328,7119
E3508,61,40,87,76,64,328,7120
E2081,82,72,70,47,57,328,7121
E6903,86,64,53,60,65,328,7122
E0435,96,66,78,43,45,328,7123
E6864,60,79,51,95,43,328,7124
E2125,69,79,60,48,72,328,7125
E4310,43,52,70,81,82,328,7126
E9242,52,71,63,54,88,328,7127
E2604,86,49,55,61,77,328,7128
E9028,49,80,49,60,90,328,7129
E0364,65,48,61,98,56,328,7130
E3200,57,60,78,83,50,328,7131
E5315,62,61,72,64,69,328,7132
E7121,70,77,51,88,42,328,7133
E7585,43,75,97,69,44,328,7134
E1451,43,93,50,53,89,328,7135
E1034,60,55,82,43,88,328,7136
E8122,78,61,74,50,65,328,7137
E1413,51,70,93,44,70,328,7138
E3579,82,51,62,53,80,328,7139
E3431,86,50,70,64,57,327,7140
E9985,85,67,72,61,42,327,7141
E4931,45,75,68,52,87,327,7142
E8680,82,55,65,43,82,327,7143
E7440,53,45,45,98,86,327,7144
E8824,53,83,64,43,84,327,7145
E4046,88,85,45,64,45,327,7146
E5651,55,58,41,80,93,327,7147
E2259,82,81,59,52,53,327,7148
E0484,62,76,58,48,83,327,7149
E6155,60,78,47,81,61,327,7150
E3229,54,46,97,49,81,327,7151
E3529,49,92,46,65,75,327,7152
E2163,52,61,49,75,90,327,7153
E3440,62,68,46,51,100,327,7154
E8787,83,46,82,42,74,327,7155
E1002,42,92,78,48,67,327,7156
E6303,48,65,79,74,61,327,7157
E8409,46,77,60,96,48,327,7158
E3197,53,68,83,73,50,327,7159
E7416,48,52,52,81,94,327,7160
E8656,48,79,50,57,93,327,7161
E2205,47,63,100,65,52,327,7162
E3374,88,60,41,64,74,327,7163
E7982,50,63,100,68,46,327,7164
E3734,88,42,46,89,62,327,7165
E5701,50,95,52,78,52,327,7166
E5088,63,43,70,95,56,327,7167
E6484,69,57,48,55,98,327,7168
E1380,58,78,52,54,85,327,7169
E7683,55,42,46,88,96,327,7170
E3228,65,75,44,56,87,327,7171
E7533,44,52,88,82,61,327,7172
E1593,63,64,77,41,82,327,7173
E2755,64,46,81,94,42,327,7174
E7079,45,91,52,55,84,327,7175
E6671,63,60,91,46,67,327,7176
E9628,80,44,76,84,43,327,7177
E0777,71,42,44,79,91,327,7178
E2991,62,75,41,59,90,327,7179
E2632,73,84,42,50,78,327,7180
E5427,40,78,76,65,68,327,7181
E2563,98,41,76,45,67,327,7182
E5119,84,57,47,48,91,327,7183
E8893,88,77,45,67,50,327,7184
E9957,65,99,46,48,69,327,7185
E4462,95,43,93,56,40,327,7186
E9587,70,83,50,69,55,327,7187
E1938,63,48,58,98,60,327,7188
E1651,72,98,44,53,60,327,7189
E3644,47,57,59,83,81,327,7190
E8757,71,93,50,60,53,327,7191
E7930,86,47,90,60,44,327,7192
E3346,55,50,65,66,91,327,7193
E5801,57,83,62,73,52,327,7194
E9160,62,55,55,64,91,327,7195
E3154,66,40,78,86,57,327,7196
E0994,55,61,90,74,47,327,7197
E4583,40,40,78,100,69,327,7198
E3464,87,43,90,40,67,327,7199
E5945,86,61,46,64,70,327,7200
E0168,62,56,72,54,83,327,7201
E0178,60,77,61,45,84,327,7202
E2383,58,53,73,85,58,327,7203
E8662,95,58,50,54,70,327,7204
E6590,53,82,86,58,48,327,7205
E0410,43,61,79,70,74,327,7206
E3673,72,73,40,48,94,327,7207
E7404,82,69,54,54,68,327,7208
E3348,51,58,64,81,73,327,7209
E4852,50,56,94,57,70,327,7210
E1099,90,80,42,73,42,327,7211
E4973,49,92,60,61,65,327,7212
E2326,59,51,67,93,57,327,7213
E9289,56,87,55,76,53,327,7214
E7133,48,86,75,56,62,327,7215
E6820,64,45,93,42,82,326,7216
E9889,54,43,86,50,93,326,7217
E1388,94,62,47,42,81,326,7218
E8299,66,78,52,78,52,326,7219
E3512,88,47,75,59,57,326,7220
E1045,98,40,49,69,70,326,7221
E6297,92,69,42,61,62,326,7222
E8868,85,47,55,41,98,326,7223
E9878,40,72,68,83,63,326,7224
E6603,59,57,78,55,77,326,7225
E5717,75,55,66,86,44,326,7226
E9936,65,67,50,60,84,326,7227
E7762,72,64,63,65,62,326,7228
E6994,76,67,55,40,88,326,7229
E4939,57,92,76,54,47,326,7230
E8866,84,43,78,41,80,326,7231
E9507,100,54,56,60,56,326,7232
E3755,71,93,47,41,74,326,7233
E2553,42,99,43,80,62,326,7234
E9117,60,75,50,100,41,326,7235
E7045,54,73,48,95,56,326,7236
E6931,82,48,60,60,76,326,7237
E2243,57,47,64,66,92,326,7238
E8623,92,74,50,65,45,326,7239
E0176,61,45,57,85,78,326,7240
E9667,50,58,55,86,77,326,7241
E5115,46,49,94,85,52,326,7242
E5853,64,50,72,81,59,326,7243
E1579,49,55,60,62,100,326,7244
E0228,57,53,64,54,98,326,7245
E9956,75,57,74,74,46,326,7246
E0886,55,85,53,93,40,326,7247
E1536,86,85,40,52,63,326,7248
E3908,50,99,68,62,47,326,7249
E1692,41,89,85,52,59,326,7250
E6564,69,71,52,77,57,326,7251
E8169,61,77,68,56,64,326,7252
E5074,63,72,47,92,52,326,7253
E3918,94,49,45,89,49,326,7254
E6997,59,65,63,74,65,326,7255
E8276,73,79,58,47,69,326,7256
E8083,86,42,73,75,50,326,7257
E0809,65,48,82,59,72,326,7258
E9897,74,42,77,92,41,326,7259
E7572,69,43,86,83,45,326,7260
E2321,95,65,81,44,41,326,7261
E0049,55,41,85,64,81,326,7262
E8583,59,61,94,64,48,326,7263
E3497,83,40,75,49,79,326,7264
E5304,81,78,41,65,61,326,7265
E4121,73,95,41,50,67,326,7266
E7213,41,49,66,95,75,326,7267
E9629,49,86,60,71,60,326,7268
E3868,75,43,92,67,49,326,7269
E3147,54,60,93,60,59,326,7270
E2042,58,52,83,68,65,326,7271
E1695,57,45,63,76,85,326,7272
E6938,94,54,40,40,98,326,7273
E3104,76,59,57,57,77,326,7274
E7116,81,63,52,52,78,326,7275
E9771,53,92,70,45,66,326,7276
E9571,65,90,40,69,62,326,7277
E7987,45,60,97,41,83,326,7278
E4248,83,53,65,58,67,326,7279
E5231,60,51,68,59,88,326,7280
E1153,53,42,77,54,100,326,7281
E5909,69,60,54,83,60,326,7282
E9273,98,49,60,54,65,326,7283
E2190,59,76,49,51,91,326,7284
E7033,90,50,64,52,70,326,7285
E9104,43,81,62,82,58,326,7286
E5519,91,44,57,72,62,326,7287
E9927,100,53,46,83,44,326,7288
E8154,49,89,76,71,41,326,7289
E1015,46,56,48,95,81,326,7290
E8881,85,88,61,47,45,326,7291
E1068,72,99,50,65,40,326,7292
E7169,53,75,47,69,82,326,7293
E5656,92,77,65,51,41,326,7294
E2953,80,48,71,67,60,326,7295
E9752,85,47,90,61,42,325,7296
E2890,83,50,57,91,44,325,7297
E3083,75,45,64,51,90,325,7298
E2842,47,55,92,66,65,325,7299
E4158,57,70,73,75,50,325,7300
E0805,81,48,84,47,65,325,7301
E5072,88,55,75,46,61,325,7302
E0269,95,41,62,53,74,325,7303
E9861,92,69,50,68,46,325,7304
E5756,53,77,49,99,47,325,7305
E9537,41,72,64,68,80,325,7306
E7650,60,44,59,87,75,325,7307
E1710,58,44,77,86,60,325,7308
E1889,72,96,40,52,65,325,7309
E0536,94,51,44,65,71,325,7310
E8229,75,88,41,61,60,325,7311
E6034,59,71,49,51,95,325,7312
E2432,57,68,61,76,63,325,7313
E3664,46,74,66,68,71,325,7314
E5451,81,56,90,48,50,325,7315
E8512,48,91,41,49,96,325,7316
E3803,70,60,64,86,45,325,7317
E1213,95,83,44,56,47,325,7318
E9369,70,74,85,48,48,325,7319
E5799,81,65,51,62,66,325,7320
E8102,57,58,96,65,49,325,7321
E5646,45,50,62,100,68,325,7322
E0160,50,46,88,55,86,325,7323
E0659,67,79,68,40,71,325,7324
E4484,91,47,58,80,49,325,7325
E2594,53,95,80,46,51,325,7326
E1181,63,56,89,48,69,325,7327
E1512,85,60,74,53,53,325,7328
E2785,49,68,84,47,77,325,7329
E2193,48,84,70,50,73,325,7330
E9837,71,64,72,51,67,325,7331
E7774,95,48,53,43,86,325,7332
E4482,43,71,86,47,78,325,7333
E8865,80,71,67,53,54,325,7334
E1604,71,44,81,51,78,325,7335
E0456,58,83,59,40,85,325,7336
E6281,56,92,67,47,63,325,7337
E7073,60,70,51,72,72,325,7338
E6948,46,88,57,68,66,325,7339
E2951,56,45,96,57,71,325,7340
E7823,100,46,63,44,72,325,7341
E5312,87,46,94,40,58,325,7342
E6352,48,52,81,80,64,325,7343
E5821,40,98,76,49,62,325,7344
E8979,95,61,47,80,42,325,7345
E8316,58,93,44,86,44,325,7346
E5670,42,72,95,74,42,325,7347
E4231,53,69,46,75,82,325,7348
E1476,75,66,70,40,74,325,7349
E9903,46,42,43,98,96,325,7350
E0460,75,90,45,63,52,325,7351
E4868,79,92,52,57,45,325,7352
E0882,78,64,93,41,49,325,7353
E6966,97,55,70,42,61,325,7354
E1866,49,71,76,81,48,325,7355
E4816,99,47,61,72,46,325,7356
E0158,45,66,79,77,58,325,7357
E4196,65,42,81,78,59,325,7358
E2827,60,68,61,45,91,325,7359
E6580,55,47,88,75,60,325,7360
E9913,75,99,44,40,67,325,7361
E7794,78,48,44,75,80,325,7362
E8182,78,74,41,88,44,325,7363
E9614,75,46,82,61,61,325,7364
E8472,60,73,43,70,79,325,7365
E6822,41,56,68,83,77,325,7366
E5749,88,72,55,44,66,325,7367
E8082,90,61,49,82,43,325,7368
E1087,54,44,51,92,84,325,7369
E6702,83,55,55,40,92,325,7370
E8386,90,48,45,90,51,324,7371
E1307,81,85,44,66,48,324,7372
E3304,79,96,61,43,45,324,7373
E5546,43,58,65,96,62,324,7374
E8008,68,99,64,45,48,324,7375
E8362,48,75,95,57,49,324,7376
E3530,67,53,81,46,77,324,7377
E9791,60,48,76,53,87,324,7378
E1042,67,56,69,79,53,324,7379
E9810,44,40,81,90,69,324,7380
E2013,66,80,43,76,59,324,7381
E3577,82,78,45,68,51,324,7382
E7897,55,79,61,52,77,324,7383
E5668,58,56,43,91,76,324,7384
E9105,73,90,53,61,47,324,7385
E3479,47,59,52,92,74,324,7386
E2803,49,59,60,94,62,324,7387
E4584,40,85,98,50,51,324,7388
E2477,82,43,62,72,65,324,7389
E5306,67,83,59,53,62,324,7390
E1679,52,71,57,81,63,324,7391
E1641,44,77,45,68,90,324,7392
E5152,44,73,53,82,72,324,7393
E3937,68,40,86,42,88,324,7394
E7680,60,44,74,67,79,324,7395
E7738,78,65,90,48,43,324,7396
E5495,52,87,53,81,51,324,7397
E0926,54,54,93,40,83,324,7398
E3824,66,94,43,60,61,324,7399
E8034,67,40,94,70,53,324,7400
E7861,65,42,98,62,57,324,7401
E5647,48,43,98,81,54,324,7402
E4350,52,62,61,61,88,324,7403
E4037,95,49,61,71,48,324,7404
E0110,43,65,51,76,89,324,7405
E3383,43,100,70,68,43,324,7406
E2782,88,90,47,49,50,324,7407
E1773,79,51,60,61,73,324,7408
E0398,50,62,58,59,95,324,7409
E8582,91,72,52,50,59,324,7410
E4330,67,76,43,74,64,324,7411
E6240,72,44,55,79,74,324,7412
E5174,43,71,90,67,53,324,7413
E6120,76,86,59,46,57,324,7414
E8804,57,49,74,98,46,324,7415
E3997,87,49,63,79,46,324,7416
E8678,48,50,100,78,48,324,7417
E0122,41,64,47,86,86,324,7418
E1274,46,74,73,42,89,324,7419
E1353,62,89,41,62,70,324,7420
E1420,100,41,65,60,58,324,7421
E1985,58,82,55,76,53,324,7422
E6818,52,55,67,72,78,324,7423
E4295,79,61,63,56,65,324,7424
E6239,44,55,67,100,58,324,7425
E0393,53,49,81,88,53,324,7426
E0783,58,61,88,54,63,324,7427
E6410,53,67,84,42,78,324,7428
E2275,70,58,51,78,67,324,7429
E8134,54,45,96,65,64,324,7430
E8978,56,83,79,40,66,324,7431
E7604,56,80,41,76,71,324,7432
E3666,98,57,66,46,57,324,7433
E1137,69,51,85,75,44,324,7434
E0339,41,75,46,67,95,324,7435
E5008,51,74,52,53,94,324,7436
E8992,59,49,80,61,75,324,7437
E7830,40,90,93,45,56,324,7438
E9703,64,45,83,53,79,324,7439
E6130,50,69,70,41,94,324,7440
E2403,72,46,69,92,45,324,7441
E2805,66,51,88,73,46,324,7442
E9513,69,40,64,99,52,324,7443
E1143,88,46,61,54,75,324,7444
E4398,70,75,67,70,42,324,7445
E5102,79,59,64,50,72,324,7446
E6001,97,72,43,46,66,324,7447
E4903,57,67,56,70,74,324,7448
E8528,57,63,82,70,52,324,7449
E7761,86,54,71,67,46,324,7450
E3973,50,76,59,94,45,324,7451
E4149,48,57,68,71,80,324,7452
E9657,71,50,70,92,41,324,7453
E3379,84,48,64,54,74,324,7454
E9020,95,46,45,42,96,324,7455
E9591,71,93,47,41,72,324,7456
E7132,49,53,55,71,96,324,7457
E5935,44,87,70,76,47,324,7458
E1484,61,55,80,57,71,324,7459
E2935,73,78,51,55,67,324,7460
E7299,82,62,67,65,48,324,7461
E7144,74,90,55,63,42,324,7462
E9308,73,58,58,62,73,324,7463
E5611,40,96,62,78,48,324,7464
E0532,59,67,55,44,99,324,7465
E2502,52,74,55,70,73,324,7466
E4194,65,94,62,59,44,324,7467
E2942,47,53,81,100,43,324,7468
E5923,58,48,56,71,91,324,7469
E0423,95,55,81,47,46,324,7470
E2539,80,52,54,72,66,324,7471
E8825,88,72,62,49,52,323,7472
E5370,63,78,40,53,89,323,7473
E3330,75,41,81,82,44,323,7474
E5536,58,69,40,73,83,323,7475
E3799,55,44,93,73,58,323,7476
E1896,62,60,42,84,75,323,7477
E1535,56,54,92,69,52,323,7478
E0230,88,50,79,42,64,323,7479
E3750,55,87,65,62,54,323,7480
E6094,41,97,67,60,58,323,7481
E3728,81,73,50,76,43,323,7482
E2643,46,54,87,73,63,323,7483
E3469,41,84,55,91,52,323,7484
E5672,40,97,48,77,61,323,7485
E7345,44,45,80,69,85,323,7486
E6441,68,76,53,70,56,323,7487
E7164,100,49,52,77,45,323,7488
E2577,85,44,51,46,97,323,7489
E6873,54,40,90,82,57,323,7490
E9478,61,58,72,72,60,323,7491
E1682,70,74,70,54,55,323,7492
E1574,49,74,57,68,75,323,7493
E4631,97,58,44,73,51,323,7494
E8188,72,78,82,46,45,323,7495
E7617,76,48,97,61,41,323,7496
E2378,65,65,54,84,55,323,7497
E8267,96,46,95,41,45,323,7498
E0870,99,57,47,70,50,323,7499
E1147,76,41,46,60,100,323,7500
E4185,93,49,85,41,55,323,7501
E6912,65,67,76,44,71,323,7502
E5848,55,52,55,95,66,323,7503
E2423,52,86,74,67,44,323,7504
E4919,84,48,77,51,63,323,7505
E8325,44,61,71,54,93,323,7506
E9291,72,87,71,48,45,323,7507
E3420,95,62,49,45,72,323,7508
E3088,73,75,57,69,49,323,7509
E4374,58,53,91,49,72,323,7510
E0277,43,55,98,48,79,323,7511
E6586,70,84,49,58,62,323,7512
E1974,69,89,45,41,79,323,7513
E1391,51,82,83,67,40,323,7514
E4246,68,89,72,53,41,323,7515
E3929,97,53,56,50,67,323,7516
E8454,77,52,57,61,76,323,7517
E6976,51,59,65,91,57,323,7518
E3210,70,69,55,49,80,323,7519
E4372,81,50,71,67,54,323,7520
E2602,78,82,69,42,52,323,7521
E2305,94,97,43,41,48,323,7522
E5376,74,44,94,44,67,323,7523
E9580,45,75,62,41,100,323,7524
E3136,84,55,74,43,67,323,7525
E7450,41,51,72,78,81,323,7526
E4292,81,84,53,57,48,323,7527
E6429,45,56,82,87,53,323,7528
E2493,44,42,68,91,78,323,7529
E9379,64,72,54,48,85,323,7530
E1134,52,83,64,46,78,323,7531
E6813,42,64,81,54,82,323,7532
E4761,96,40,44,52,91,323,7533
E1367,84,45,52,50,92,323,7534
E6438,73,80,47,60,63,323,7535
E7684,84,82,43,65,49,323,7536
E7628,70,54,63,76,60,323,7537
E0284,63,59,62,48,91,323,7538
E7593,100,48,57,45,73,323,7539
E0214,83,55,57,72,56,323,7540
E6289,47,56,49,81,90,323,7541
E2299,94,43,72,45,69,323,7542
E0877,60,97,44,66,56,323,7543
E1610,85,91,41,45,61,323,7544
E8074,57,51,82,60,73,323,7545
E3234,67,72,52,40,92,323,7546
E8522,68,40,73,47,95,323,7547
E0671,42,70,55,58,98,323,7548
E4362,52,84,59,47,81,323,7549
E0464,59,92,40,88,44,323,7550
E3766,63,54,44,99,63,323,7551
E7086,43,66,78,56,80,323,7552
E2821,50,47,85,87,54,323,7553
E3780,58,68,96,57,43,322,7554
E3176,95,42,40,99,46,322,7555
E4844,61,58,47,56,100,322,7556
E6249,46,90,53,75,58,322,7557
E9658,40,99,45,65,73,322,7558
E8829,45,81,93,60,43,322,7559
E1418,70,90,57,58,47,322,7560
E6033,53,48,73,67,81,322,7561
E8086,46,99,45,83,49,322,7562
E5707,46,82,88,61,45,322,7563
E1248,60,62,65,57,78,322,7564
E5622,78,71,63,63,47,322,7565
E3759,83,50,62,79,48,322,7566
E9447,69,90,50,61,52,322,7567
E9814,55,44,75,61,87,322,7568
E1804,57,56,67,48,94,322,7569
E3143,49,100,43,50,80,322,7570
E6100,94,90,46,41,51,322,7571
E7322,53,76,84,66,43,322,7572
E0091,56,60,48,64,94,322,7573
E1785,49,58,63,99,53,322,7574
E2082,75,40,61,69,77,322,7575
E9332,56,57,64,59,86,322,7576
E2720,100,65,66,41,50,322,7577
E6676,76,100,54,45,47,322,7578
E1105,70,61,50,95,46,322,7579
E7516,66,50,72,92,42,322,7580
E8366,66,55,71,40,90,322,7581
E7434,46,96,68,62,50,322,7582
E6089,49,55,91,42,85,322,7583
E8998,94,75,41,40,72,322,7584
E4334,63,100,66,44,49,322,7585
E2335,50,73,86,58,55,322,7586
E5958,55,58,100,57,52,322,7587
E7831,63,94,65,54,46,322,7588
E5498,90,64,40,60,68,322,7589
E2659,92,82,46,44,58,322,7590
E0860,51,71,73,51,76,322,7591
E1870,68,63,85,52,54,322,7592
E9924,58,47,70,58,89,322,7593
E2098,79,82,72,49,40,322,7594
E5857,64,68,73,61,56,322,7595
E5782,47,44,47,84,100,322,7596
E6284,59,62,76,53,72,322,7597
E8707,43,70,62,84,63,322,7598
E0224,45,75,56,54,92,322,7599
E3480,70,78,66,53,55,322,7600
E5317,92,57,71,51,51,322,7601
E2241,42,78,52,76,74,322,7602
E9386,43,42,69,77,91,322,7603
E7363,81,71,45,51,74,322,7604
E6261,60,49,83,57,73,322,7605
E5149,46,69,58,58,91,322,7606
E4641,49,60,46,100,67,322,7607
E3451,44,67,48,68,95,322,7608
E1859,86,62,78,53,43,322,7609
E8005,62,69,50,98,43,322,7610
E8395,61,93,75,50,43,322,7611
E8739,54,87,88,40,53,322,7612
E6294,99,64,58,51,50,322,7613
E5453,89,73,60,54,46,322,7614
E5258,47,53,59,86,77,322,7615
E7962,45,75,61,80,61,322,7616
E9084,85,47,59,78,53,322,7617
E3642,52,74,75,64,57,322,7618
E3091,56,41,62,75,88,322,7619
E9177,75,70,52,75,50,322,7620
E7007,50,66,56,62,88,322,7621
E1774,85,41,45,54,97,322,7622
E0692,53,44,70,80,75,322,7623
E7772,47,100,57,74,44,322,7624
E3858,43,60,73,88,58,322,7625
E3444,69,68,52,50,83,322,7626
E1979,67,64,46,93,52,322,7627
E7413,52,54,45,93,78,322,7628
E3366,88,59,60,54,60,321,7629
E3005,42,50,94,59,76,321,7630
E2004,43,42,93,66,77,321,7631
E0716,48,93,44,83,53,321,7632
E5539,77,53,96,46,49,321,7633
E7430,59,63,47,75,77,321,7634
E7655,99,50,71,48,53,321,7635
E8580,59,86,91,41,44,321,7636
E5832,51,40,52,97,81,321,7637
E1690,46,90,48,97,40,321,7638
E7174,46,69,62,96,48,321,7639
E0507,70,94,50,56,51,321,7640
E0289,59,60,71,68,63,321,7641
E1252,77,50,68,69,57,321,7642
E8199,44,90,40,75,72,321,7643
E0782,86,76,59,52,48,321,7644
E4428,71,44,57,56,93,321,7645
E1565,84,95,50,41,51,321,7646
E3036,64,54,60,95,48,321,7647
E2169,71,42,100,56,52,321,7648
E9167,64,61,96,59,41,321,7649
E0898,75,72,67,46,61,321,7650
E4400,81,59,60,57,64,321,7651
E4254,46,89,92,52,42,321,7652
E7303,54,48,81,59,79,321,7653
E1872,75,77,40,82,47,321,7654
E0068,99,44,59,54,65,321,7655
E1887,94,41,52,80,54,321,7656
E4182,57,68,70,45,81,321,7657
E1684,83,49,77,59,53,321,7658
E8523,66,56,73,84,42,321,7659
E9511,48,80,55,45,93,321,7660
E1233,41,75,41,64,100,321,7661
E4506,55,49,48,71,98,321,7662
E4620,71,56,49,63,82,321,7663
E4164,72,52,45,95,57,321,7664
E0095,47,43,100,55,76,321,7665
E5459,42,80,83,65,51,321,7666
E5583,54,64,93,45,65,321,7667
E1466,71,66,53,69,62,321,7668
E8813,50,45,87,61,78,321,7669
E0900,69,97,40,40,75,321,7670
E4951,46,63,58,69,85,321,7671
E2526,69,53,55,74,70,321,7672
E9886,84,55,67,66,49,321,7673
E8168,64,45,85,83,44,321,7674
E9133,54,64,61,42,100,321,7675
E7008,46,81,85,53,56,321,7676
E3159,66,50,52,53,100,321,7677
E6066,92,71,43,68,47,321,7678
E3566,60,87,80,50,44,321,7679
E3920,90,58,66,64,43,321,7680
E8196,63,79,40,56,83,321,7681
E9436,44,100,55,49,73,321,7682
E8458,83,55,64,68,51,321,7683
E6206,84,95,51,44,47,321,7684
E1295,85,42,67,87,40,321,7685
E5696,84,44,52,42,99,321,7686
E8488,42,91,56,72,60,321,7687
E6063,74,46,76,67,58,321,7688
E2051,71,98,60,49,43,321,7689
E8139,69,62,64,41,85,321,7690
E4980,44,58,100,75,44,321,7691
E2177,71,61,97,45,47,321,7692
E0197,83,73,73,44,48,321,7693
E1478,81,72,60,57,51,321,7694
E5628,43,88,73,66,51,321,7695
E9043,55,67,42,89,68,321,7696
E2986,72,48,55,84,62,321,7697
E1487,83,45,46,100,47,321,7698
E0648,81,75,46,74,45,321,7699
E3995,51,90,45,73,62,321,7700
E8626,70,71,78,41,61,321,7701
E8028,98,41,49,45,88,321,7702
E5777,73,72,75,54,47,321,7703
E3198,87,62,43,64,65,321,7704
E4508,40,49,53,98,81,321,7705
E6658,73,74,45,67,62,321,7706
E2315,92,72,41,74,42,321,7707
E6301,69,85,49,76,42,321,7708
E8451,88,41,53,50,89,321,7709
E9802,49,80,43,77,72,321,7710
E5649,47,48,61,66,99,321,7711
E9963,62,72,65,72,50,321,7712
E7221,45,82,54,50,89,320,7713
E1240,47,44,63,98,68,320,7714
E1955,47,54,53,76,90,320,7715
E5921,41,72,78,67,62,320,7716
E9782,60,42,67,81,70,320,7717
E8157,45,58,71,90,56,320,7718
E1939,65,42,67,73,73,320,7719
E9437,55,55,89,43,78,320,7720
E6849,70,60,88,43,59,320,7721
E9075,46,64,79,88,43,320,7722
E3167,79,57,73,51,60,320,7723
E6080,42,76,64,74,64,320,7724
E1119,65,51,49,95,60,320,7725
E6225,69,100,45,58,48,320,7726
E1779,63,48,64,53,92,320,7727
E5594,64,73,42,88,53,320,7728
E2560,79,49,67,67,58,320,7729
E3185,53,92,45,72,58,320,7730
E9290,98,65,56,59,42,320,7731
E2836,94,96,42,44,44,320,7732
E6874,63,67,92,50,48,320,7733
E8688,65,69,52,67,67,320,7734
E7483,81,76,43,72,48,320,7735
E1621,44,51,85,84,56,320,7736
E5787,59,85,71,50,55,320,7737
E4932,64,71,55,70,60,320,7738
E6770,85,61,64,53,57,320,7739
E5053,57,53,89,49,72,320,7740
E2505,92,67,52,50,59,320,7741
E2314,77,46,55,87,55,320,7742
E4912,52,67,92,62,47,320,7743
E5286,88,52,56,84,40,320,7744
E2434,51,70,65,75,59,320,7745
E6167,58,50,46,80,86,320,7746
E2283,82,49,50,69,70,320,7747
E0016,86,55,60,53,66,320,7748
E1953,46,56,94,80,44,320,7749
E9774,86,40,41,96,57,320,7750
E2633,66,54,58,90,52,320,7751
E1700,59,44,44,79,94,320,7752
E9253,88,50,44,46,92,320,7753
E5141,64,74,42,82,58,320,7754
E1634,42,40,71,99,68,320,7755
E5608,52,60,64,92,52,320,7756
E1208,50,85,84,40,61,320,7757
E1732,70,53,60,76,61,320,7758
E5038,42,75,70,46,87,320,7759
E6154,57,56,50,58,99,320,7760
E1193,78,84,70,46,42,320,7761
E7156,69,56,59,77,59,320,7762
E6345,100,49,67,40,64,320,7763
E3627,54,89,41,47,89,320,7764
E0569,43,43,59,99,76,320,7765
E4526,67,56,60,40,97,320,7766
E3050,51,68,71,74,56,320,7767
E6801,47,62,96,74,41,320,7768
E1815,91,45,46,96,42,320,7769
E0341,76,71,49,68,56,320,7770
E7445,44,80,55,43,98,320,7771
E6779,48,41,52,97,82,320,7772
E0164,41,66,69,50,94,320,7773
E9619,58,60,100,46,56,320,7774
E6989,43,60,90,47,80,320,7775
E7189,56,56,61,94,52,319,7776
E4264,72,52,44,100,51,319,7777
E9526,51,90,62,47,69,319,7778
E4762,64,71,54,82,48,319,7779
E1734,97,74,50,54,44,319,7780
E0812,60,80,78,46,55,319,7781
E4879,55,85,75,64,40,319,7782
E5898,42,77,88,56,56,319,7783
E5259,74,57,77,66,45,319,7784
E3588,100,41,85,43,50,319,7785
E2545,80,97,52,43,47,319,7786
E8108,54,65,96,46,58,319,7787
E2437,59,62,90,51,57,319,7788
E9475,78,43,49,60,89,319,7789
E7278,58,80,55,81,45,319,7790
E6363,64,92,53,65,45,319,7791
E7217,75,62,82,40,60,319,7792
E8603,80,72,55,69,43,319,7793
E3026,92,43,70,53,61,319,7794
E1186,85,71,51,60,52,319,7795
E5978,62,66,88,46,57,319,7796
E1952,46,96,80,55,42,319,7797
E2568,97,63,42,43,74,319,7798
E2422,76,73,56,52,62,319,7799
E5387,49,84,64,82,40,319,7800
E3148,92,73,44,53,57,319,7801
E0865,46,67,59,71,76,319,7802
E4225,45,88,53,40,93,319,7803
E4289,84,88,49,52,46,319,7804
E8490,45,77,49,81,67,319,7805
E8883,72,44,48,88,67,319,7806
E1757,83,70,53,71,42,319,7807
E2375,70,49,59,84,57,319,7808
E1549,95,40,55,62,67,319,7809
E3896,54,69,60,65,71,319,7810
E2941,42,51,47,94,85,319,7811
E6414,48,72,93,52,54,319,7812
E5575,53,88,67,66,45,319,7813
E1107,46,69,50,75,79,319,7814
E3651,54,73,57,82,53,319,7815
E9624,75,48,44,92,60,319,7816
E9296,59,58,78,82,42,319,7817
E7881,62,59,50,97,51,319,7818
E8907,40,90,52,80,57,319,7819
E2631,70,44,76,71,58,319,7820
E0966,75,60,57,80,47,319,7821
E2009,44,71,58,51,95,319,7822
E2788,41,62,100,41,75,319,7823
E3471,58,48,92,65,56,319,7824
E2524,48,74,59,64,74,319,7825
E2626,61,42,92,84,40,319,7826
E9500,76,64,64,68,47,319,7827
E6926,83,61,40,78,57,319,7828
E2564,72,60,91,51,45,319,7829
E2693,51,72,79,44,73,319,7830
E4827,86,86,53,42,52,319,7831
E0266,57,64,90,60,48,319,7832
E1424,73,40,70,66,70,319,7833
E7925,65,42,56,63,93,319,7834
E0903,84,68,71,55,41,319,7835
E6774,47,66,83,40,83,319,7836
E3984,69,58,66,59,67,319,7837
E5896,55,83,47,82,52,319,7838
E4057,77,49,49,64,80,319,7839
E6998,53,66,44,76,80,319,7840
E5842,54,94,78,41,52,319,7841
E9682,93,51,52,62,61,319,7842
E3867,82,83,58,42,54,319,7843
E7398,43,51,70,58,97,319,7844
E7966,85,55,44,91,44,319,7845
E8574,55,67,61,84,52,319,7846
E6306,73,62,46,80,58,319,7847
E0303,78,46,83,60,52,319,7848
E5599,60,65,88,41,65,319,7849
E8996,43,71,65,51,89,319,7850
E3762,83,40,85,45,66,319,7851
E8721,56,72,59,70,62,319,7852
E9943,41,57,51,93,77,319,7853
E5080,69,55,74,58,63,319,7854
E2342,70,70,65,72,42,319,7855
E2391,76,78,59,60,46,319,7856
E1971,79,65,72,58,45,319,7857
E0863,53,54,86,81,45,319,7858
E0250,53,83,64,41,78,319,7859
E9097,49,63,55,55,97,319,7860
E1986,63,54,69,68,65,319,7861
E2508,62,75,51,68,63,319,7862
E1056,95,51,66,46,61,319,7863
E5716,93,40,58,56,71,318,7864
E0130,66,50,71,90,41,318,7865
E3859,44,59,92,76,47,318,7866
E6309,43,98,64,56,57,318,7867
E6617,81,41,53,86,57,318,7868
E8055,74,55,57,56,76,318,7869
E2985,52,70,64,56,76,318,7870
E4019,78,44,68,64,64,318,7871
E8548,60,70,73,55,60,318,7872
E9146,70,55,52,83,58,318,7873
E3008,69,51,63,83,52,318,7874
E8980,78,92,49,40,59,318,7875
E3970,49,57,51,92,69,318,7876
E5830,85,59,45,55,74,318,7877
E8006,58,57,79,77,47,318,7878
E0914,45,52,95,77,49,318,7879
E1997,63,72,72,42,69,318,7880
E7521,50,88,43,96,41,318,7881
E2794,56,49,86,82,45,318,7882
E7630,97,51,75,42,53,318,7883
E2899,92,52,42,88,44,318,7884
E5251,96,41,43,89,49,318,7885
E4051,50,47,63,59,99,318,7886
E8666,62,58,60,47,91,318,7887
E3419,68,58,66,84,42,318,7888
E9595,55,40,67,59,97,318,7889
E6050,62,47,89,73,47,318,7890
E7056,94,59,54,67,44,318,7891
E1364,93,50,43,58,74,318,7892
E2269,51,41,77,96,53,318,7893
E8951,55,88,53,77,45,318,7894
E2057,41,53,73,68,83,318,7895
E8066,58,77,42,65,76,318,7896
E4033,41,60,50,86,81,318,7897
E5518,86,47,54,89,42,318,7898
E3618,70,67,56,47,78,318,7899
E3168,41,76,75,61,65,318,7900
E2677,40,88,41,68,81,318,7901
E2616,92,46,42,65,73,318,7902
E6383,85,68,41,60,64,318,7903
E7021,73,78,80,45,42,318,7904
E9421,65,43,93,74,43,318,7905
E0386,54,45,71,76,72,318,7906
E0997,77,59,73,58,51,318,7907
E5202,60,78,54,49,77,318,7908
E7388,52,61,61,91,53,318,7909
E9491,41,62,62,73,80,318,7910
E5273,55,89,46,55,73,318,7911
E8658,74,83,47,71,43,318,7912
E2487,47,65,43,79,84,318,7913
E7384,49,89,54,76,50,318,7914
E3226,79,86,66,47,40,318,7915
E8850,66,76,48,68,60,318,7916
E4303,54,65,70,83,46,318,7917
E4555,74,86,49,62,47,318,7918
E5101,56,80,41,54,87,318,7919
E8586,72,96,47,59,44,318,7920
E1703,67,75,57,51,68,318,7921
E3475,47,75,83,61,52,318,7922
E5796,40,89,40,87,62,318,7923
E1890,57,83,78,54,46,318,7924
E0887,47,53,72,56,90,318,7925
E3712,58,43,65,68,84,318,7926
E2464,89,67,45,49,68,318,7927
E7799,62,45,76,59,76,318,7928
E5537,40,98,71,57,52,318,7929
E3751,65,93,60,53,47,318,7930
E8271,100,40,65,41,72,318,7931
E3311,71,73,50,42,82,318,7932
E3423,61,68,56,49,84,318,7933
E8467,80,87,47,42,62,318,7934
E0356,49,62,56,89,62,318,7935
E3046,48,46,95,65,64,318,7936
E3783,52,40,70,98,57,317,7937
E4002,55,46,53,92,71,317,7938
E9881,45,67,81,56,68,317,7939
E9544,46,100,62,47,62,317,7940
E6672,40,69,58,75,75,317,7941
E2164,50,99,74,52,42,317,7942
E1717,44,64,76,67,66,317,7943
E3452,76,63,53,51,74,317,7944
E5267,41,67,58,76,75,317,7945
E0624,56,61,71,58,71,317,7946
E2672,59,55,55,49,99,317,7947
E5855,63,61,51,96,46,317,7948
E8726,56,74,54,62,71,317,7949
E6416,66,59,65,44,83,317,7950
E8156,44,52,74,98,49,317,7951
E6986,76,58,76,54,53,317,7952
E4953,49,62,74,59,73,317,7953
E7210,48,68,54,67,80,317,7954
E0857,64,71,48,54,80,317,7955
E8576,70,42,71,63,71,317,7956
E5275,41,47,94,52,83,317,7957
E0208,53,65,73,79,47,317,7958
E5093,54,66,59,75,63,317,7959
E2778,47,60,68,63,79,317,7960
E2337,81,90,45,47,54,317,7961
E4406,49,71,60,65,72,317,7962
E7912,61,77,56,65,58,317,7963
E0180,74,63,40,89,51,317,7964
E1577,50,48,90,68,61,317,7965
E6045,77,40,59,43,98,317,7966
E0005,70,65,66,70,46,317,7967
E6250,69,53,79,62,54,317,7968
E2237,64,72,73,62,46,317,7969
E9181,56,72,58,45,86,317,7970
E7157,74,67,55,50,71,317,7971
E4828,44,72,82,55,64,317,7972
E6528,95,41,41,42,98,317,7973
E2221,80,66,58,61,52,317,7974
E8844,42,96,57,41,81,317,7975
E5838,74,47,41,70,85,317,7976
E4233,79,48,76,67,47,317,7977
E9790,86,48,62,48,73,317,7978
E5809,92,62,59,52,52,317,7979
E3796,61,84,40,82,50,317,7980
E1878,58,64,54,86,55,317,7981
E1727,47,91,68,61,50,317,7982
E4934,55,60,72,76,54,317,7983
E9807,71,57,48,51,90,317,7984
E8311,83,45,42,77,70,317,7985
E3151,92,68,42,67,48,317,7986
E7458,40,49,82,80,66,317,7987
E4605,44,48,79,85,61,317,7988
E4249,51,64,52,90,60,317,7989
E4701,43,72,86,53,63,317,7990
E8716,57,61,59,79,61,317,7991
E2849,55,42,66,73,81,317,7992
E7971,52,58,99,49,59,317,7993
E7589,66,49,58,64,80,317,7994
E7792,63,94,45,69,46,317,7995
E9368,64,54,80,66,53,317,7996
E2960,69,44,53,59,92,317,7997
E2698,94,59,45,59,60,317,7998
E1078,98,47,57,41,74,317,7999
E1640,40,47,89,61,80,317,8000
E2696,84,64,70,47,52,317,8001
E9762,63,58,76,40,80,317,8002
E7505,43,74,74,75,51,317,8003
E0380,46,52,83,57,79,317,8004
E5016,68,75,53,64,57,317,8005
E0894,40,77,46,80,74,317,8006
E0334,80,49,65,55,68,317,8007
E0974,44,50,93,85,45,317,8008
E7682,59,82,55,56,65,317,8009
E7142,50,68,73,48,78,317,8010
E9919,62,96,43,40,75,316,8011
E4443,42,53,79,49,93,316,8012
E6831,70,73,77,47,49,316,8013
E9317,67,78,45,71,55,316,8014
E7758,77,66,67,50,56,316,8015
E5500,89,72,43,42,70,316,8016
E1728,98,46,56,69,47,316,8017
E0138,81,40,91,47,57,316,8018
E9884,94,61,47,63,51,316,8019
E1599,54,60,58,87,57,316,8020
E8290,41,55,89,72,59,316,8021
E6517,80,67,65,60,44,316,8022
E8942,72,90,66,42,46,316,8023
E3020,81,55,74,61,45,316,8024
E4757,62,61,52,80,61,316,8025
E7693,65,88,56,54,53,316,8026
E1299,97,58,59,61,41,316,8027
E1662,63,89,47,42,75,316,8028
E1328,91,74,44,57,50,316,8029
E5113,44,75,59,79,59,316,8030
E0124,82,45,86,61,42,316,8031
E6524,65,62,89,53,47,316,8032
E4418,100,47,47,59,63,316,8033
E1783,49,42,85,99,41,316,8034
E1869,95,45,77,50,49,316,8035
E4379,56,82,64,58,56,316,8036
E0051,68,73,54,71,50,316,8037
E7686,56,40,81,72,67,316,8038
E3316,56,53,65,94,48,316,8039
E1426,84,77,58,41,56,316,8040
E2306,93,42,51,42,88,316,8041
E6627,76,49,71,80,40,316,8042
E0830,82,43,48,92,51,316,8043
E8637,62,58,78,63,55,316,8044
E0330,48,100,70,43,55,316,8045
E3408,57,66,88,41,64,316,8046
E5440,78,41,91,65,41,316,8047
E3534,79,45,93,57,42,316,8048
E7549,57,94,42,57,66,316,8049
E3954,70,56,58,45,87,316,8050
E5130,41,93,70,65,47,316,8051
E1140,45,40,87,50,94,316,8052
E3852,89,43,41,96,47,316,8053
E8885,58,43,70,78,67,316,8054
E9439,64,56,84,54,58,316,8055
E1024,42,55,74,70,75,316,8056
E4012,87,64,74,42,49,316,8057
E0097,77,40,54,79,66,316,8058
E5447,50,68,74,60,64,316,8059
E8827,83,50,51,73,59,316,8060
E7342,51,51,74,77,63,316,8061
E9392,99,45,71,48,53,316,8062
E1587,80,76,47,61,52,316,8063
E3872,41,52,64,86,73,316,8064
E4471,63,59,98,56,40,316,8065
E1847,45,76,79,55,61,316,8066
E3924,71,91,44,70,40,316,8067
E8252,47,42,93,65,69,316,8068
E1421,43,42,70,84,77,316,8069
E3504,54,60,86,53,63,316,8070
E3849,54,44,55,98,65,316,8071
E0542,70,81,58,59,48,316,8072
E8749,91,44,69,42,70,316,8073
E7060,56,57,51,67,85,316,8074
E0718,97,43,78,57,41,316,8075
E7773,48,48,80,84,56,316,8076
E1898,78,66,51,63,58,316,8077
E9545,72,49,96,59,40,316,8078
E9715,54,53,92,46,71,316,8079
E8585,79,64,58,72,43,316,8080
E0150,66,67,68,51,64,316,8081
E7998,43,66,63,45,99,316,8082
E4727,61,64,69,73,49,316,8083
E9773,66,54,90,49,57,316,8084
E3081,67,42,74,56,77,316,8085
E5409,85,45,79,48,59,316,8086
E3609,77,68,64,47,60,316,8087
E1031,54,55,59,58,89,315,8088
E6305,58,93,56,43,65,315,8089
E7357,64,49,65,90,47,315,8090
E6005,56,79,50,56,74,315,8091
E1616,73,97,40,64,41,315,8092
E7795,49,77,80,46,63,315,8093
E2392,45,67,56,82,65,315,8094
E7879,61,48,63,66,77,315,8095
E8343,73,98,59,44,41,315,8096
E6103,91,49,65,46,64,315,8097
E8511,48,57,90,63,57,315,8098
E4615,54,42,79,52,88,315,8099
E4387,65,82,41,65,62,315,8100
E8254,52,87,63,49,64,315,8101
E0465,79,43,57,44,92,315,8102
E5397,41,51,85,78,60,315,8103
E9010,40,79,54,72,70,315,8104
E3597,55,56,52,77,75,315,8105
E9520,63,47,71,44,90,315,8106
E0561,42,73,54,83,63,315,8107
E8310,64,66,72,51,62,315,8108
E3000,68,46,64,69,68,315,8109
E7543,68,86,41,45,75,315,8110
E6417,68,58,50,57,82,315,8111
E4991,62,71,50,55,77,315,8112
E7482,42,86,93,41,53,315,8113
E4100,42,51,79,97,46,315,8114
E4764,71,67,62,52,63,315,8115
E0668,77,44,63,86,45,315,8116
E2681,73,68,62,51,61,315,8117
E7196,45,59,66,90,55,315,8118
E1824,96,45,55,70,49,315,8119
E5881,62,65,82,41,65,315,8120
E1586,83,91,48,52,41,315,8121
E9049,43,40,59,99,74,315,8122
E7347,60,44,87,78,46,315,8123
E1595,96,74,42,41,62,315,8124
E9323,67,53,59,62,74,315,8125
E9268,83,72,40,51,69,315,8126
E8497,78,85,59,42,51,315,8127
E6787,55,78,40,48,94,315,8128
E4483,81,77,71,46,40,315,8129
E9091,69,79,87,40,40,315,8130
E5987,81,51,65,65,53,315,8131
E9700,84,46,64,62,59,315,8132
E1558,56,99,42,48,70,315,8133
E2817,92,62,57,64,40,315,8134
E9679,66,40,100,52,57,315,8135
E4990,71,60,58,56,70,315,8136
E7609,49,47,87,67,65,315,8137
E9694,84,47,99,42,43,315,8138
E2680,92,75,43,45,60,315,8139
E7031,56,42,77,93,47,315,8140
E8289,81,87,59,40,48,315,8141
E1868,91,70,66,42,46,315,8142
E3233,85,46,56,79,49,315,8143
E0739,67,44,54,68,82,315,8144
E6241,43,51,86,67,68,315,8145
E1972,47,85,58,58,67,315,8146
E3313,64,51,100,49,51,315,8147
E0348,43,80,78,54,60,315,8148
E7289,67,57,69,43,79,315,8149
E9192,98,56,57,43,61,315,8150
E2031,67,60,68,76,44,315,8151
E2078,79,77,44,42,73,315,8152
E1626,95,41,55,40,84,315,8153
E7296,69,46,80,52,68,315,8154
E4941,83,57,53,71,51,315,8155
E7209,55,49,41,84,86,315,8156
E9906,60,70,88,48,49,315,8157
E5241,84,77,43,57,54,315,8158
E7207,53,45,45,89,83,315,8159
E1454,66,64,41,71,73,315,8160
E8261,52,93,40,80,49,314,8161
E4370,40,71,43,85,75,314,8162
E1276,80,59,71,61,43,314,8163
E6059,59,64,55,52,84,314,8164
E7140,78,48,62,40,86,314,8165
E0530,89,46,47,70,62,314,8166
E2647,46,94,74,40,60,314,8167
E5446,48,65,55,51,95,314,8168
E5481,90,52,47,48,77,314,8169
E6834,77,57,52,61,67,314,8170
E3129,67,61,48,85,53,314,8171
E0092,45,52,71,62,84,314,8172
E1795,46,61,78,67,62,314,8173
E1693,46,68,86,54,60,314,8174
E7972,40,63,74,68,69,314,8175
E6028,90,62,48,74,40,314,8176
E2014,55,49,45,65,100,314,8177
E3208,42,84,51,52,85,314,8178
E4360,98,63,53,48,52,314,8179
E6642,49,65,92,56,52,314,8180
E9539,46,91,49,68,60,314,8181
E7414,66,54,65,67,62,314,8182
E7195,52,91,52,64,55,314,8183
E9143,66,46,82,71,49,314,8184
E8136,67,62,74,41,70,314,8185
E9378,45,42,86,72,69,314,8186
E2541,82,63,71,49,49,314,8187
E5330,58,83,40,71,62,314,8188
E5211,63,52,74,84,41,314,8189
E9445,59,42,79,52,82,314,8190
E1883,45,86,47,44,92,314,8191
E9723,53,55,57,80,69,314,8192
E7913,46,100,41,82,45,314,8193
E0619,46,67,84,58,59,314,8194
E3748,42,53,59,100,60,314,8195
E8412,64,82,50,53,65,314,8196
E0475,91,57,80,42,44,314,8197
E0115,51,98,73,46,46,314,8198
E5280,50,75,45,71,73,314,8199
E7891,59,43,62,54,96,314,8200
E5467,63,57,62,55,77,314,8201
E5665,61,68,60,45,80,314,8202
E6199,45,73,41,60,95,314,8203
E8655,69,43,94,40,68,314,8204
E3641,43,63,60,82,66,314,8205
E8792,52,45,84,54,79,314,8206
E6522,72,41,46,64,91,314,8207
E5124,77,43,64,90,40,314,8208
E4699,49,55,65,70,75,314,8209
E9182,83,41,84,65,41,314,8210
E3232,55,42,54,71,92,314,8211
E6280,46,50,74,90,54,314,8212
E0650,53,43,77,55,86,314,8213
E8954,74,50,71,69,50,314,8214
E6340,49,68,58,96,43,314,8215
E3691,86,65,51,40,72,314,8216
E9819,76,69,64,53,52,314,8217
E7148,46,84,62,60,62,314,8218
E4850,99,55,52,60,48,314,8219
E1763,68,54,93,52,47,314,8220
E8336,49,86,48,66,65,314,8221
E4221,74,57,52,66,65,314,8222
E6020,60,46,46,64,98,314,8223
E1492,40,85,41,51,97,314,8224
E1335,60,52,87,55,60,314,8225
E5573,96,46,60,47,65,314,8226
E0329,56,80,46,54,78,314,8227
E2282,51,88,87,44,44,314,8228
E6008,84,69,46,44,71,314,8229
E0442,47,55,98,49,65,314,8230
E3635,45,54,72,94,49,314,8231
E4343,78,50,69,74,43,314,8232
E9288,47,51,60,84,71,313,8233
E6606,91,43,53,81,45,313,8234
E6419,100,67,57,43,46,313,8235
E2926,67,74,66,50,56,313,8236
E6768,63,42,64,80,64,313,8237
E8312,98,49,46,79,41,313,8238
E8043,78,55,53,48,79,313,8239
E5339,69,57,65,60,62,313,8240
E7441,49,86,53,83,42,313,8241
E2222,73,83,56,46,55,313,8242
E9377,58,82,53,71,49,313,8243
E5089,73,76,42,57,65,313,8244
E2268,47,81,60,59,66,313,8245
E7113,45,63,48,94,63,313,8246
E6634,45,44,76,51,97,313,8247
E5424,91,40,46,92,44,313,8248
E0129,60,72,40,95,46,313,8249
E0235,72,64,44,48,85,313,8250
E3394,41,93,49,54,76,313,8251
E0179,41,76,71,77,48,313,8252
E4479,47,52,50,87,77,313,8253
E0012,51,81,76,65,40,313,8254
E9208,82,54,87,45,45,313,8255
E7579,62,54,63,54,80,313,8256
E1479,43,65,83,50,72,313,8257
E5507,95,41,69,62,46,313,8258
E4487,75,45,44,50,99,313,8259
E7309,42,61,82,84,44,313,8260
E4672,95,43,68,59,48,313,8261
E6745,61,63,41,75,73,313,8262
E7999,46,61,71,89,46,313,8263
E9763,62,86,56,62,47,313,8264
E6551,57,70,99,41,46,313,8265
E6663,55,98,68,50,42,313,8266
E6981,69,40,97,49,58,313,8267
E5262,65,94,69,44,41,313,8268
E9034,47,71,65,58,72,313,8269
E5658,42,47,78,91,55,313,8270
E2824,63,46,87,43,74,313,8271
E5123,46,51,43,87,86,313,8272
E6972,63,41,58,89,62,313,8273
E0373,79,55,78,44,57,313,8274
E3878,57,72,45,99,40,313,8275
E8682,48,50,64,59,92,313,8276
E1653,84,44,83,44,58,313,8277
E2411,52,50,96,60,55,313,8278
E8736,66,47,52,99,49,313,8279
E1164,51,57,71,53,81,313,8280
E0262,41,45,76,91,60,313,8281
E1981,95,48,52,71,47,313,8282
E6778,46,91,45,66,65,313,8283
E2774,64,45,90,60,54,313,8284
E4589,58,82,49,49,75,313,8285
E9428,51,70,46,71,75,313,8286
E1357,56,62,60,95,40,313,8287
E5562,59,63,72,47,72,313,8288
E0256,67,49,44,60,93,313,8289
E4921,97,58,44,49,65,313,8290
E2249,80,50,50,59,74,313,8291
E1936,83,86,49,46,49,313,8292
E4532,88,52,90,41,42,313,8293
E7898,76,47,95,50,45,313,8294
E9620,94,45,44,47,83,313,8295
E0801,65,97,48,49,54,313,8296
E8446,44,64,47,67,91,313,8297
E8078,66,66,52,73,56,313,8298
E0598,43,56,57,69,88,313,8299
E9304,43,50,87,77,56,313,8300
E6191,62,61,68,71,51,313,8301
E5526,89,74,56,43,50,312,8302
E4755,57,94,60,45,56,312,8303
E2603,68,62,43,56,83,312,8304
E7328,42,90,68,52,60,312,8305
E2586,99,40,70,56,47,312,8306
E9504,57,59,68,75,53,312,8307
E6253,91,46,47,85,43,312,8308
E3264,65,89,53,41,64,312,8309
E8475,46,48,69,84,65,312,8310
E5822,84,65,47,75,41,312,8311
E3883,94,48,45,69,56,312,8312
E8650,66,53,75,46,72,312,8313
E5246,40,46,94,71,61,312,8314
E0504,57,86,85,44,40,312,8315
E3323,40,45,57,82,88,312,8316
E2945,66,42,54,51,99,312,8317
E4139,50,55,65,76,66,312,8318
E3343,95,44,89,41,43,312,8319
E2318,53,48,82,47,82,312,8320
E4179,71,63,60,42,76,312,8321
E9828,40,71,88,52,61,312,8322
E9322,45,59,90,61,57,312,8323
E4687,100,61,53,54,44,312,8324
E3084,80,70,46,69,47,312,8325
E1284,87,52,64,49,60,312,8326
E9785,71,57,53,75,56,312,8327
E0054,48,61,92,50,61,312,8328
E9341,42,56,83,81,50,312,8329
E9346,57,43,41,87,84,312,8330
E9548,100,41,78,49,44,312,8331
E9617,95,47,59,71,40,312,8332
E6608,71,68,48,43,82,312,8333
E8015,59,75,73,57,48,312,8334
E7085,73,70,82,44,43,312,8335
E5274,59,48,99,56,50,312,8336
E7642,87,50,45,61,69,312,8337
E0181,42,69,68,51,82,312,8338
E7358,44,65,69,49,85,312,8339
E0109,86,57,41,64,64,312,8340
E2133,46,85,62,45,74,312,8341
E9223,44,79,63,60,66,312,8342
E3140,40,46,81,52,93,312,8343
E6659,59,74,85,44,50,312,8344
E6872,45,85,65,40,77,312,8345
E9761,83,70,41,48,70,312,8346
E3478,65,72,88,41,46,312,8347
E4952,85,46,66,49,66,312,8348
E2912,46,54,68,44,100,312,8349
E8305,61,55,57,90,49,312,8350
E7970,78,81,59,47,47,312,8351
E1337,47,64,70,86,45,312,8352
E9420,56,54,56,96,50,312,8353
E3483,54,70,70,53,65,312,8354
E9610,84,46,70,70,42,312,8355
E2979,48,64,51,81,68,312,8356
E6467,40,52,61,96,63,312,8357
E4497,78,47,47,86,54,312,8358
E3286,89,78,56,43,46,312,8359
E0223,56,62,50,89,55,312,8360
E3518,44,75,42,92,59,312,8361
E9706,72,77,42,75,46,312,8362
E1534,81,40,64,49,77,311,8363
E6040,76,46,65,54,70,311,8364
E6713,75,47,52,42,95,311,8365
E5443,51,59,95,57,49,311,8366
E2944,70,49,72,78,42,311,8367
E2214,52,77,41,66,75,311,8368
E6047,83,50,58,42,78,311,8369
E8922,79,43,43,87,59,311,8370
E3631,64,71,54,53,69,311,8371
E9059,45,58,57,98,53,311,8372
E8109,41,76,90,63,41,311,8373
E6122,59,44,92,41,75,311,8374
E1192,44,40,81,62,84,311,8375
E3604,60,76,56,48,71,311,8376
E4353,51,81,76,44,59,311,8377
E1980,85,68,52,62,44,311,8378
E4148,49,72,84,57,49,311,8379
E5066,65,42,74,48,82,311,8380
E5695,62,51,64,73,61,311,8381
E4453,76,77,41,63,54,311,8382
E9973,44,46,45,76,100,311,8383
E3318,64,55,85,67,40,311,8384
E5111,52,45,82,71,61,311,8385
E5353,87,44,89,43,48,311,8386
E9374,40,71,77,70,53,311,8387
E0156,55,40,75,91,50,311,8388
E5828,50,57,78,78,48,311,8389
E0630,59,64,54,60,74,311,8390
E9645,47,59,77,49,79,311,8391
E4059,42,78,70,77,44,311,8392
E3770,44,53,79,79,56,311,8393
E5911,66,91,54,40,60,311,8394
E4826,52,48,79,77,55,311,8395
E6693,69,52,60,58,72,311,8396
E2274,43,82,99,43,44,311,8397
E1283,71,44,61,53,82,311,8398
E0199,94,83,42,52,40,311,8399
E6079,45,44,78,92,52,311,8400
E3022,53,58,64,68,68,311,8401
E1457,40,86,44,49,92,311,8402
E6499,71,83,61,46,50,311,8403
E9710,76,80,60,46,49,311,8404
E7750,92,53,70,45,51,311,8405
E8530,59,54,93,61,44,311,8406
E4079,41,78,44,100,48,311,8407
E7016,67,70,45,84,45,311,8408
E1313,40,46,92,43,90,311,8409
E2673,78,76,57,40,60,311,8410
E4554,58,52,74,67,60,311,8411
E4382,82,74,51,51,53,311,8412
E6452,69,49,46,81,66,311,8413
E0517,88,52,75,41,55,311,8414
E2087,59,47,67,92,46,311,8415
E1811,67,78,62,52,52,311,8416
E9992,59,44,89,47,72,311,8417
E4978,63,74,65,54,55,311,8418
E2304,86,67,49,58,51,311,8419
E8027,50,62,47,98,53,310,8420
E0514,49,89,46,64,62,310,8421
E2157,51,65,41,53,100,310,8422
E7443,50,59,46,55,100,310,8423
E9854,42,62,48,65,93,310,8424
E8287,85,66,50,61,48,310,8425
E3163,41,54,62,76,77,310,8426
E4883,40,69,67,52,82,310,8427
E5390,76,62,51,78,43,310,8428
E6746,40,53,42,88,87,310,8429
E9448,82,45,54,69,60,310,8430
E9916,56,41,70,95,48,310,8431
E1196,56,100,50,56,48,310,8432
E9115,60,71,49,42,88,310,8433
E9429,55,93,57,47,58,310,8434
E4442,74,45,68,76,47,310,8435
E0715,64,40,66,72,68,310,8436
E4093,44,49,86,85,46,310,8437
E9575,50,87,87,42,44,310,8438
E0764,47,60,87,43,73,310,8439
E3726,45,55,82,50,78,310,8440
E2165,47,78,49,65,71,310,8441
E9121,88,43,53,63,63,310,8442
E2750,49,92,40,75,54,310,8443
E2460,40,68,49,85,68,310,8444
E2083,57,83,62,67,41,310,8445
E7422,100,52,76,41,41,310,8446
E6618,58,46,68,42,96,310,8447
E0899,52,66,79,68,45,310,8448
E8536,49,89,48,44,80,310,8449
E8877,51,69,41,71,78,310,8450
E8025,42,70,70,55,73,310,8451
E6795,73,47,56,40,94,310,8452
E1255,58,49,74,52,77,310,8453
E0723,77,50,48,63,72,310,8454
E5882,57,55,83,41,74,310,8455
E1085,77,53,68,72,40,310,8456
E2088,59,62,40,78,71,310,8457
E4904,69,60,44,65,72,310,8458
E4856,48,50,71,65,76,310,8459
E9519,46,63,91,65,45,310,8460
E1796,42,84,52,54,78,310,8461
E4476,59,85,43,63,60,310,8462
E3014,80,41,99,42,48,310,8463
E7988,54,56,74,86,40,310,8464
E4905,76,89,44,59,42,310,8465
E0280,84,61,50,49,66,310,8466
E1340,46,56,84,48,76,310,8467
E4756,55,58,80,46,71,310,8468
E6185,55,44,79,84,48,310,8469
E6292,65,41,47,88,69,310,8470
E6143,42,63,60,63,82,310,8471
E6072,92,47,81,43,47,310,8472
E7118,49,55,47,95,64,310,8473
E7293,87,58,51,63,51,310,8474
E8054,55,93,48,60,54,310,8475
E4311,54,78,47,61,70,310,8476
E5460,41,76,64,41,88,310,8477
E2343,92,51,82,40,45,310,8478
E3315,72,48,54,95,41,310,8479
E6245,79,43,81,62,45,310,8480
E8485,62,41,75,77,55,310,8481
E2236,72,49,55,40,94,310,8482
E9329,55,86,60,59,50,310,8483
E6367,94,47,54,64,50,309,8484
E2115,52,50,44,89,74,309,8485
E3758,43,84,42,85,55,309,8486
E2885,40,40,94,87,48,309,8487
E0078,80,71,68,48,42,309,8488
E7935,51,65,47,69,77,309,8489
E0211,94,62,43,59,51,309,8490
E6896,61,40,92,57,59,309,8491
E2975,75,73,71,41,49,309,8492
E6090,64,51,61,60,73,309,8493
E5884,80,53,60,64,52,309,8494
E6706,51,58,45,96,59,309,8495
E2973,96,82,43,40,48,309,8496
E5625,90,51,46,79,43,309,8497
E1982,72,89,49,58,41,309,8498
E5458,59,53,65,60,72,309,8499
E7095,49,43,91,43,83,309,8500
E4720,66,70,52,49,72,309,8501
E2450,42,55,71,85,56,309,8502
E5413,58,94,51,51,55,309,8503
E0244,58,63,51,97,40,309,8504
E7896,51,80,45,50,83,309,8505
E5653,79,49,63,60,58,309,8506
E5607,60,48,89,57,55,309,8507
E9892,47,67,93,45,57,309,8508
E0048,75,60,68,65,41,309,8509
E9607,56,75,45,85,48,309,8510
E6523,46,54,61,70,78,309,8511
E3633,40,53,44,99,73,309,8512
E0428,48,82,73,46,60,309,8513
E2534,62,42,73,78,54,309,8514
E4510,47,63,40,75,84,309,8515
E5382,86,44,60,79,40,309,8516
E9078,81,50,74,55,49,309,8517
E8762,46,48,67,55,93,309,8518
E8929,55,80,47,73,54,309,8519
E8627,66,40,72,85,46,309,8520
E3996,52,73,84,54,46,309,8521
E9638,75,63,69,48,54,309,8522
E4318,64,59,49,67,70,309,8523
E2107,86,71,40,46,66,309,8524
E7117,84,51,50,70,54,309,8525
E8630,65,57,91,42,54,309,8526
E0656,45,42,94,52,76,309,8527
E3443,56,57,82,65,49,309,8528
E7510,42,85,73,48,61,309,8529
E6270,50,43,83,47,86,309,8530
E3225,51,49,75,58,76,309,8531
E6940,75,71,42,79,42,309,8532
E4272,96,41,45,52,75,309,8533
E5705,58,41,54,89,67,309,8534
E6078,49,90,49,72,49,309,8535
E5163,68,49,55,63,74,309,8536
E9107,72,56,77,60,44,309,8537
E8746,70,73,43,83,40,309,8538
E5768,93,44,83,44,45,309,8539
E9866,69,76,42,72,50,309,8540
E2825,85,58,48,77,41,309,8541
E6326,41,67,62,77,62,309,8542
E1491,78,55,41,67,68,309,8543
E8487,41,89,45,89,44,308,8544
E9549,45,60,53,69,81,308,8545
E9971,72,41,92,56,47,308,8546
E2709,62,71,69,43,63,308,8547
E5257,84,50,47,67,60,308,8548
E4080,73,93,52,48,42,308,8549
E6686,85,42,55,79,47,308,8550
E7670,53,77,48,83,47,308,8551
E9768,47,40,73,95,53,308,8552
E5907,57,79,49,71,52,308,8553
E1608,98,42,47,62,59,308,8554
E3662,65,86,52,62,43,308,8555
E2562,58,54,62,65,69,308,8556
E4320,54,77,61,70,46,308,8557
E6132,64,66,70,65,43,308,8558
E2902,40,49,94,69,56,308,8559
E8768,49,57,60,84,58,308,8560
E1756,66,90,46,65,41,308,8561
E6529,81,61,43,61,62,308,8562
E2426,81,87,43,53,44,308,8563
E6816,57,63,44,84,60,308,8564
E0382,67,84,40,46,71,308,8565
E9647,55,54,42,68,89,308,8566
E0226,75,61,50,61,61,308,8567
E2495,58,65,75,45,65,308,8568
E8141,52,58,41,86,71,308,8569
E7736,43,64,67,81,53,308,8570
E1910,50,49,87,45,77,308,8571
E1215,40,86,70,61,51,308,8572
E3543,79,64,46,77,42,308,8573
E3671,48,77,54,71,58,308,8574
E2609,54,65,56,80,53,308,8575
E5348,54,92,47,51,64,308,8576
E5087,44,82,52,81,49,308,8577
E0194,88,42,87,41,50,308,8578
E5790,68,82,45,59,54,308,8579
E0458,72,78,47,41,70,308,8580
E8174,87,48,46,74,53,308,8581
E5496,48,73,54,61,72,308,8582
E4609,41,86,74,46,61,308,8583
E5517,51,59,60,58,80,308,8584
E0683,57,74,64,58,55,308,8585
E6607,75,74,49,57,53,308,8586
E6175,69,44,98,57,40,308,8587
E9076,43,54,96,44,71,308,8588
E1163,66,64,42,91,45,308,8589
E6074,41,51,55,96,65,308,8590
E6913,76,64,49,43,75,307,8591
E0987,43,50,56,97,61,307,8592
E5674,47,68,45,85,62,307,8593
E2957,66,59,80,60,42,307,8594
E6162,72,61,41,72,61,307,8595
E9979,47,62,58,86,54,307,8596
E7331,66,78,67,54,42,307,8597
E7206,72,78,62,42,53,307,8598
E0094,84,47,53,44,79,307,8599
E9175,56,65,60,68,58,307,8600
E1225,65,46,41,56,99,307,8601
E4405,84,52,64,62,45,307,8602
E5069,73,53,44,94,43,307,8603
E5148,47,57,57,61,85,307,8604
E1740,96,56,42,73,40,307,8605
E8862,53,57,58,68,71,307,8606
E5728,73,59,53,82,40,307,8607
E4275,58,61,73,75,40,307,8608
E3846,57,57,48,80,65,307,8609
E0155,57,40,83,42,85,307,8610
E3124,71,66,51,52,67,307,8611
E7902,53,64,40,60,90,307,8612
E2598,79,60,68,46,54,307,8613
E6899,78,77,69,40,43,307,8614
E1965,79,41,47,74,66,307,8615
E0795,55,47,66,47,92,307,8616
E2376,62,81,54,66,44,307,8617
E1101,79,69,55,62,42,307,8618
E6984,43,67,44,92,61,307,8619
E0192,46,69,55,42,95,307,8620
E5762,48,91,40,83,45,307,8621
E8198,56,61,97,44,49,307,8622
E9713,86,46,58,58,59,307,8623
E8493,57,71,86,52,41,307,8624
E3051,67,62,52,58,68,307,8625
E7851,76,66,65,57,43,307,8626
E3840,81,66,48,40,72,307,8627
E7203,82,52,40,55,78,307,8628
E8462,67,69,76,41,54,307,8629
E8917,49,67,90,51,50,307,8630
E9547,72,82,56,56,41,307,8631
E7992,58,58,46,95,50,307,8632
E3472,55,97,66,48,41,307,8633
E1518,46,69,64,74,54,307,8634
E9588,71,62,43,67,64,307,8635
E4766,60,97,56,47,47,307,8636
E6400,43,56,52,61,95,307,8637
E0954,59,51,65,46,86,307,8638
E6490,92,52,55,49,59,307,8639
E9668,68,82,40,44,73,307,8640
E9690,67,91,45,59,45,307,8641
E4333,42,61,80,58,66,307,8642
E6468,85,63,40,55,64,307,8643
E3991,93,47,64,51,52,307,8644
E4726,54,54,73,76,50,307,8645
E5142,78,65,67,40,57,307,8646
E5963,77,54,43,69,64,307,8647
E6397,44,47,71,96,49,307,8648
E0007,41,71,79,66,50,307,8649
E3801,43,67,60,71,66,307,8650
E6897,52,50,40,100,65,307,8651
E2731,51,92,53,63,48,307,8652
E4917,62,54,59,57,74,306,8653
E5201,62,86,55,57,46,306,8654
E8375,64,75,48,76,43,306,8655
E3165,81,42,56,51,76,306,8656
E2547,54,59,58,47,88,306,8657
E0904,42,41,65,96,62,306,8658
E9407,77,62,59,48,60,306,8659
E6869,59,44,64,87,52,306,8660
E2995,42,81,41,46,96,306,8661
E3923,48,73,79,56,50,306,8662
E9626,48,57,68,92,41,306,8663
E7005,70,69,71,56,40,306,8664
E2627,87,59,45,50,65,306,8665
E6497,64,62,55,42,83,306,8666
E1983,81,61,52,72,40,306,8667
E4117,65,69,51,64,57,306,8668
E5542,69,62,71,58,46,306,8669
E8068,47,68,98,50,43,306,8670
E3341,76,49,62,56,63,306,8671
E2063,80,46,98,42,40,306,8672
E3922,42,45,82,80,57,306,8673
E6462,86,49,56,57,58,306,8674
E7980,67,51,50,95,43,306,8675
E9047,44,44,92,51,75,306,8676
E9536,56,74,91,44,41,306,8677
E5307,43,67,65,57,74,306,8678
E5117,81,44,49,81,51,306,8679
E5203,57,48,76,73,52,306,8680
E4795,52,56,58,83,57,306,8681
E8073,46,87,65,48,60,306,8682
E8026,44,84,75,47,56,306,8683
E0457,57,61,74,52,62,306,8684
E4143,68,57,44,88,49,306,8685
E6415,59,78,44,56,69,306,8686
E4307,52,84,64,50,56,306,8687
E0912,67,50,76,47,66,306,8688
E3774,64,68,40,88,46,306,8689
E3327,81,45,57,43,80,306,8690
E5448,42,42,82,81,59,306,8691
E7019,52,63,89,52,50,306,8692
E1823,40,52,71,76,67,306,8693
E1124,51,61,50,74,70,306,8694
E1382,55,87,49,57,58,306,8695
E0088,42,69,87,53,55,306,8696
E4268,71,48,63,58,66,306,8697
E4288,59,82,51,50,64,306,8698
E4634,72,49,67,78,40,306,8699
E0400,87,49,61,61,48,306,8700
E4439,44,54,71,96,40,305,8701
E6097,57,96,60,46,46,305,8702
E5673,58,74,78,50,45,305,8703
E6258,97,50,72,46,40,305,8704
E2114,47,71,44,59,84,305,8705
E6024,96,65,54,50,40,305,8706
E2312,47,57,74,67,60,305,8707
E0029,51,100,42,48,64,305,8708
E5256,86,47,65,54,53,305,8709
E4737,65,55,48,41,96,305,8710
E6880,68,55,41,99,42,305,8711
E1668,67,51,85,48,54,305,8712
E2689,44,98,44,73,46,305,8713
E8257,82,40,94,44,45,305,8714
E3216,55,47,74,78,51,305,8715
E1344,59,68,45,51,82,305,8716
E1239,83,42,68,52,60,305,8717
E0309,56,99,51,59,40,305,8718
E1325,52,77,50,86,40,305,8719
E2005,45,62,58,43,97,305,8720
E1993,51,65,44,78,67,305,8721
E7093,44,43,71,75,72,305,8722
E1862,40,50,63,77,75,305,8723
E9339,60,70,55,44,76,305,8724
E7352,49,57,45,67,87,305,8725
E9326,42,78,58,74,53,305,8726
E0490,92,41,86,41,45,305,8727
E4875,55,71,54,72,53,305,8728
E1547,43,40,69,76,77,305,8729
E10000,51,58,40,56,100,305,8730
E8941,70,79,68,42,46,305,8731
E1576,51,55,63,57,79,305,8732
E9918,71,67,46,81,40,305,8733
E2716,48,93,51,52,61,305,8734
E8197,51,49,79,42,84,305,8735
E5356,54,60,70,69,52,305,8736
E5103,54,69,60,57,65,305,8737
E4997,58,68,70,67,42,305,8738
E2509,58,50,73,72,52,305,8739
E0086,41,96,78,40,50,305,8740
E9305,63,68,46,61,67,305,8741
E5178,61,79,61,61,43,305,8742
E8781,49,77,48,63,68,305,8743
E9410,49,90,61,48,57,305,8744
E5357,58,58,84,45,60,305,8745
E4796,99,52,56,55,43,305,8746
E6728,62,72,44,42,85,305,8747
E8064,41,58,96,60,50,305,8748
E5745,50,83,47,68,57,305,8749
E8228,72,93,47,45,48,305,8750
E7032,51,64,42,92,55,304,8751
E4810,51,73,43,78,59,304,8752
E6635,51,57,100,52,44,304,8753
E7292,81,44,62,61,56,304,8754
E6927,78,51,81,50,44,304,8755
E6893,60,80,59,62,43,304,8756
E5041,85,42,62,48,67,304,8757
E0025,77,41,73,47,66,304,8758
E0811,74,40,66,53,71,304,8759
E4735,57,66,44,71,66,304,8760
E7566,98,49,51,56,50,304,8761
E4045,74,56,48,48,78,304,8762
E3262,62,61,54,72,55,304,8763
E3514,42,58,56,57,91,304,8764
E5897,86,48,44,81,45,304,8765
E4635,46,77,76,43,62,304,8766
E1302,51,51,94,43,65,304,8767
E3367,55,50,44,60,95,304,8768
E8273,42,95,63,51,53,304,8769
E5237,65,60,42,65,72,304,8770
E8207,72,45,55,50,82,304,8771
E9112,76,41,59,40,88,304,8772
E0992,79,58,80,41,46,304,8773
E7076,44,80,40,69,71,304,8774
E3795,40,81,85,53,45,304,8775
E1132,76,75,62,51,40,304,8776
E7621,69,41,79,59,56,304,8777
E1064,48,63,49,45,99,304,8778
E2036,84,58,57,58,47,304,8779
E2238,45,78,46,54,81,304,8780
E1508,78,40,50,72,64,304,8781
E6757,53,94,65,44,48,304,8782
E5217,85,56,72,42,49,304,8783
E6308,43,75,52,79,55,304,8784
E5689,88,71,43,58,44,304,8785
E2454,56,91,50,47,60,304,8786
E9003,57,63,60,77,47,304,8787
E7767,44,53,53,60,94,304,8788
E8443,58,51,74,68,53,304,8789
E3620,57,61,52,51,83,304,8790
E0691,48,41,49,95,71,304,8791
E7744,42,62,47,93,60,304,8792
E3626,48,73,46,72,65,304,8793
E2976,50,48,72,80,54,304,8794
E8021,83,52,44,61,64,304,8795
E4685,60,56,62,80,46,304,8796
E8167,72,47,64,46,75,304,8797
E5618,45,90,63,54,52,304,8798
E2971,68,54,71,45,66,304,8799
E6364,43,73,50,52,86,304,8800
E7582,93,61,51,43,56,304,8801
E8547,98,55,49,60,42,304,8802
E8932,78,73,41,42,70,304,8803
E9040,45,48,61,89,61,304,8804
E3043,57,63,54,55,75,304,8805
E1730,76,50,44,91,43,304,8806
E4403,65,53,91,50,45,304,8807
E4262,75,65,47,72,45,304,8808
E0274,88,49,60,47,60,304,8809
E3428,42,81,89,40,52,304,8810
E9495,81,55,69,57,42,304,8811
E3426,77,41,55,91,40,304,8812
E3575,41,81,63,62,57,304,8813
E4161,64,68,69,41,61,303,8814
E4869,42,51,90,49,71,303,8815
E6657,56,47,52,53,95,303,8816
E5771,63,41,73,85,41,303,8817
E4160,46,41,76,92,48,303,8818
E5013,56,77,51,62,57,303,8819
E6574,48,67,54,72,62,303,8820
E8591,58,52,56,72,65,303,8821
E5058,58,47,93,41,64,303,8822
E4686,96,46,59,51,51,303,8823
E2027,56,72,65,61,49,303,8824
E9211,40,74,58,91,40,303,8825
E7350,71,67,50,59,56,303,8826
E1010,59,54,42,94,54,303,8827
E9155,45,64,60,89,45,303,8828
E0441,95,44,43,78,43,303,8829
E0157,50,79,55,64,55,303,8830
E5755,64,99,48,40,52,303,8831
E3526,48,80,59,43,73,303,8832
E8728,65,58,66,40,74,303,8833
E2528,45,41,63,92,62,303,8834
E5729,40,85,72,63,43,303,8835
E0667,40,49,77,88,49,303,8836
E2102,56,43,91,57,56,303,8837
E5528,52,43,70,71,67,303,8838
E2076,53,64,84,50,52,303,8839
E1646,70,83,50,40,60,303,8840
E4914,60,78,43,77,45,303,8841
E9453,47,48,53,72,83,303,8842
E1945,51,55,96,57,44,303,8843
E3980,65,65,45,56,72,303,8844
E0058,79,40,66,60,58,303,8845
E8370,76,55,51,65,56,303,8846
E0486,43,44,90,46,80,303,8847
E1352,61,45,50,97,50,303,8848
E6898,53,85,59,62,44,303,8849
E3648,62,53,46,74,68,303,8850
E6571,49,53,57,92,52,303,8851
E7393,54,81,73,49,46,303,8852
E7845,43,49,61,55,95,303,8853
E9733,44,49,52,77,81,303,8854
E0677,57,41,49,69,87,303,8855
E0046,63,45,50,64,81,303,8856
E4485,96,42,43,80,42,303,8857
E3335,45,99,44,53,62,303,8858
E1038,59,41,74,74,55,303,8859
E9363,42,80,47,49,85,303,8860
E5887,78,54,63,45,63,303,8861
E9189,81,59,63,46,54,303,8862
E1858,99,40,49,54,61,303,8863
E2763,77,47,47,47,85,303,8864
E1200,53,95,45,41,69,303,8865
E3221,83,44,41,78,57,303,8866
E7323,61,56,67,77,42,303,8867
E7409,50,53,95,42,63,303,8868
E0090,82,46,65,40,69,302,8869
E3903,61,78,57,49,57,302,8870
E0971,41,84,41,47,89,302,8871
E1748,47,49,42,69,95,302,8872
E5224,58,78,50,71,45,302,8873
E0573,53,48,76,57,68,302,8874
E1635,57,49,60,94,42,302,8875
E9815,59,88,44,51,60,302,8876
E0023,89,46,64,50,53,302,8877
E2412,64,86,47,47,58,302,8878
E4073,90,65,53,45,49,302,8879
E4467,61,55,60,81,45,302,8880
E9239,54,47,89,60,52,302,8881
E1066,61,45,52,86,58,302,8882
E4809,46,57,73,70,56,302,8883
E3336,42,42,91,50,77,302,8884
E3204,60,46,50,88,58,302,8885
E0745,49,74,60,55,64,302,8886
E7739,55,74,64,63,46,302,8887
E8744,67,53,58,56,68,302,8888
E6360,58,66,42,91,45,302,8889
E3986,75,75,50,46,56,302,8890
E1920,63,56,71,62,50,302,8891
E0762,53,63,74,55,57,302,8892
E8782,64,46,93,52,47,302,8893
E9259,44,80,50,82,46,302,8894
E7976,41,72,53,94,42,302,8895
E8989,58,40,43,63,98,302,8896
E8864,64,51,73,56,58,302,8897
E8609,83,45,59,57,58,302,8898
E1922,45,51,49,65,92,302,8899
E4120,61,45,65,49,82,302,8900
E4821,42,42,98,70,50,302,8901
E2000,57,61,81,57,46,302,8902
E2295,43,75,53,54,77,302,8903
E2846,89,56,43,62,52,302,8904
E4702,43,54,54,99,52,302,8905
E0533,41,54,65,91,51,302,8906
E5139,43,98,41,68,52,302,8907
E4841,79,41,45,79,58,302,8908
E1918,53,75,43,49,82,302,8909
E2746,63,42,60,78,59,302,8910
E0470,84,60,46,68,44,302,8911
E3623,47,98,46,69,42,302,8912
E8595,48,42,76,74,62,302,8913
E2483,70,45,42,55,90,302,8914
E0689,67,40,94,40,61,302,8915
E2224,66,55,49,90,42,302,8916
E5368,49,74,51,49,79,302,8917
E2215,78,40,52,40,92,302,8918
E3961,52,77,46,42,85,302,8919
E0057,71,74,52,50,55,302,8920
E4027,68,42,60,43,89,302,8921
E3837,82,65,50,58,47,302,8922
E7172,51,66,41,79,65,302,8923
E0582,81,41,60,68,52,302,8924
E3907,67,66,60,53,56,302,8925
E8293,43,99,45,49,66,302,8926
E7218,87,41,42,43,89,302,8927
E4660,45,78,62,70,47,302,8928
E8878,47,97,54,60,44,302,8929
E4650,60,99,43,52,48,302,8930
E0337,48,62,56,69,66,301,8931
E8407,80,42,58,55,66,301,8932
E9664,72,40,54,64,71,301,8933
E7000,49,60,66,42,84,301,8934
E7141,74,79,46,47,55,301,8935
E3866,42,48,96,45,70,301,8936
E9414,89,57,51,51,53,301,8937
E8558,63,75,48,47,68,301,8938
E6202,45,74,45,54,83,301,8939
E8667,58,80,52,42,69,301,8940
E6062,56,64,62,64,55,301,8941
E4754,51,42,54,87,67,301,8942
E9398,92,55,60,52,42,301,8943
E1584,79,40,57,48,77,301,8944
E7580,50,72,80,44,55,301,8945
E9036,51,42,90,77,41,301,8946
E5589,58,41,46,89,67,301,8947
E0644,42,63,45,63,88,301,8948
E3069,59,65,45,80,52,301,8949
E3029,68,80,49,61,43,301,8950
E3969,54,73,79,46,49,301,8951
E4617,91,57,53,40,60,301,8952
E0440,47,64,62,76,52,301,8953
E7338,61,47,45,57,91,301,8954
E8058,40,65,78,70,48,301,8955
E3132,73,42,49,46,91,301,8956
E9413,70,85,44,49,53,301,8957
E5872,41,51,78,49,82,301,8958
E7967,62,52,48,89,50,301,8959
E3764,62,50,89,51,49,301,8960
E9697,41,62,58,89,51,301,8961
E1836,58,49,83,49,62,301,8962
E2738,69,74,73,43,42,301,8963
E0322,58,43,57,99,44,301,8964
E4989,74,47,59,57,64,301,8965
E1133,57,58,75,51,60,301,8966
E1559,58,62,69,51,61,301,8967
E7224,99,64,41,44,53,301,8968
E2398,58,50,79,49,65,301,8969
E8695,86,47,55,55,58,301,8970
E2521,60,64,58,41,78,301,8971
E3463,47,68,84,55,47,301,8972
E4586,81,45,70,46,59,301,8973
E6195,52,40,51,99,58,300,8974
E3115,66,42,71,70,51,300,8975
E8632,52,59,46,86,57,300,8976
E3265,70,60,57,45,68,300,8977
E7438,76,43,65,75,41,300,8978
E4077,85,56,74,42,43,300,8979
E1001,43,87,54,53,63,300,8980
E5461,88,51,57,43,61,300,8981
E1809,75,42,52,55,76,300,8982
E5297,43,65,89,62,41,300,8983
E5452,51,50,41,85,73,300,8984
E5512,61,59,88,50,42,300,8985
E6213,50,91,60,49,50,300,8986
E2143,49,67,53,43,88,300,8987
E0660,81,41,90,44,44,300,8988
E1427,62,41,59,52,86,300,8989
E6411,54,95,60,45,46,300,8990
E7158,47,60,51,91,51,300,8991
E5189,96,62,48,53,41,300,8992
E0331,80,56,46,76,42,300,8993
E1675,48,78,80,53,41,300,8994
E0312,54,52,53,72,69,300,8995
E1257,70,43,45,53,89,300,8996
E9057,46,40,71,84,59,300,8997
E4662,63,60,66,63,48,300,8998
E0033,47,57,94,54,48,300,8999
E6334,51,71,62,74,42,300,9000
E8906,69,69,77,45,40,300,9001
E3646,88,52,42,48,70,300,9002
E7893,50,62,89,54,45,300,9003
E7929,60,65,51,67,57,300,9004
E7047,48,48,86,64,54,300,9005
E4271,67,63,52,58,60,300,9006
E2247,73,63,49,67,48,300,9007
E7901,56,43,66,48,87,300,9008
E2229,61,54,59,71,55,300,9009
E4285,93,45,41,51,70,300,9010
E4076,56,45,47,72,80,300,9011
E5676,56,50,58,44,92,300,9012
E1339,69,79,59,41,52,300,9013
E6503,58,68,52,55,67,300,9014
E2089,58,66,64,58,54,300,9015
E1377,64,48,87,57,44,300,9016
E6330,55,62,56,83,44,300,9017
E1180,66,51,83,60,40,300,9018
E2963,50,42,68,53,87,300,9019
E9982,57,53,53,77,60,300,9020
E8933,56,44,55,58,87,300,9021
E1802,62,75,67,43,53,300,9022
E3179,98,70,41,47,44,300,9023
E8369,48,50,66,80,56,300,9024
E4563,48,67,71,45,68,299,9025
E7961,41,69,60,52,77,299,9026
E3939,45,73,67,49,65,299,9027
E3133,65,61,81,40,52,299,9028
E7601,58,56,59,73,53,299,9029
E5011,58,89,44,52,56,299,9030
E9797,52,71,79,42,55,299,9031
E9337,77,58,56,57,51,299,9032
E2879,62,70,62,50,55,299,9033
E3701,48,64,41,73,73,299,9034
E5234,83,64,54,44,54,299,9035
E0781,69,55,42,50,83,299,9036
E7385,59,42,42,98,58,299,9037
E2209,51,52,40,91,65,299,9038
E4599,87,57,50,58,47,299,9039
E8939,99,70,41,40,49,299,9040
E6640,94,53,47,42,63,299,9041
E8669,43,55,74,54,73,299,9042
E8608,63,56,70,59,51,299,9043
E7596,77,77,64,41,40,299,9044
E5847,46,93,45,60,55,299,9045
E8040,44,75,82,45,53,299,9046
E1365,53,47,47,92,60,299,9047
E5765,59,47,90,52,51,299,9048
E5698,40,69,42,52,96,299,9049
E6058,53,55,60,77,54,299,9050
E9949,50,64,81,47,57,299,9051
E8002,73,67,54,48,57,299,9052
E4748,47,61,74,57,60,299,9053
E5221,62,55,67,49,66,299,9054
E7864,66,46,43,60,84,299,9055
E1468,46,72,69,49,63,299,9056
E6703,68,42,61,49,79,299,9057
E3438,62,60,55,48,74,299,9058
E3933,51,58,67,49,74,299,9059
E6299,48,84,58,65,44,299,9060
E3576,40,59,59,73,68,299,9061
E9581,42,70,83,61,43,299,9062
E5473,46,100,43,51,59,299,9063
E0096,62,46,57,59,75,299,9064
E9139,61,43,62,85,48,299,9065
E8750,60,81,62,51,45,299,9066
E8085,41,94,45,73,46,299,9067
E0349,55,62,64,65,53,299,9068
E6715,92,51,46,56,54,299,9069
E3959,61,61,72,42,62,298,9070
E5597,72,65,44,54,63,298,9071
E4168,58,42,57,68,73,298,9072
E2395,82,65,66,44,41,298,9073
E4928,66,44,64,56,68,298,9074
E3567,56,61,87,51,43,298,9075
E6550,52,49,93,48,56,298,9076
E6890,44,62,57,94,41,298,9077
E3815,42,96,55,63,42,298,9078
E5196,58,40,55,46,99,298,9079
E7288,59,84,52,51,52,298,9080
E3885,76,43,60,46,73,298,9081
E7955,71,44,55,73,55,298,9082
E7332,60,46,40,91,61,298,9083
E6477,52,50,90,42,64,298,9084
E6232,80,47,50,40,81,298,9085
E7594,43,46,63,77,69,298,9086
E9760,64,77,41,57,59,298,9087
E8691,48,68,52,84,46,298,9088
E7717,59,62,52,62,63,298,9089
E2309,44,77,44,60,73,298,9090
E9411,40,70,53,92,43,298,9091
E0118,80,53,71,46,48,298,9092
E1673,42,99,57,42,58,298,9093
E9122,44,47,59,68,80,298,9094
E1271,71,58,54,44,71,298,9095
E3268,92,47,55,58,46,298,9096
E9140,59,81,46,55,57,298,9097
E1282,66,94,47,40,51,298,9098
E2554,67,40,81,47,63,298,9099
E5914,56,49,54,85,54,298,9100
E6637,54,44,96,46,58,298,9101
E6166,54,73,65,61,45,298,9102
E4499,53,41,65,89,49,297,9103
E2260,70,63,49,56,59,297,9104
E6975,59,40,40,72,86,297,9105
E3807,74,57,64,45,57,297,9106
E3777,67,70,51,44,65,297,9107
E0622,66,88,50,51,42,297,9108
E9656,58,70,69,45,55,297,9109
E5645,57,71,73,43,53,297,9110
E0369,45,49,84,51,68,297,9111
E8690,61,54,93,44,45,297,9112
E8553,40,96,50,47,64,297,9113
E2802,82,53,60,59,43,297,9114
E8349,56,91,51,58,41,297,9115
E1665,40,84,51,67,55,297,9116
E7178,45,57,51,80,64,297,9117
E2994,69,75,70,40,43,297,9118
E4977,44,59,63,48,83,297,9119
E8769,54,78,73,43,49,297,9120
E0868,69,56,44,50,78,297,9121
E2257,64,76,77,40,40,297,9122
E8279,46,44,58,55,94,297,9123
E9826,95,59,49,40,54,297,9124
E5972,50,51,49,51,96,297,9125
E2256,44,59,89,54,51,297,9126
E6694,45,52,90,42,68,297,9127
E0299,49,47,53,79,69,297,9128
E8124,63,50,40,96,48,297,9129
E4896,52,75,47,44,79,297,9130
E6789,75,50,48,80,44,297,9131
E3131,81,44,49,57,66,297,9132
E1754,75,57,71,47,47,297,9133
E1156,78,40,61,62,56,297,9134
E3209,63,47,50,67,70,297,9135
E8150,54,71,59,69,44,297,9136
E3951,59,67,50,46,75,297,9137
E4454,48,74,49,43,83,297,9138
E0065,40,42,76,88,51,297,9139
E9991,46,60,40,66,85,297,9140
E0991,58,64,48,60,67,297,9141
E5354,54,68,43,72,60,297,9142
E3196,55,58,46,63,75,297,9143
E7149,86,48,50,63,50,297,9144
E1072,50,79,66,44,58,297,9145
E2407,69,48,72,64,44,297,9146
E3164,48,57,51,99,42,297,9147
E5726,63,43,62,74,55,297,9148
E2286,57,44,89,62,44,296,9149
E9293,53,48,79,61,55,296,9150
E2415,42,55,60,47,92,296,9151
E0616,65,49,55,72,55,296,9152
E5944,92,41,68,47,48,296,9153
E6237,43,90,47,50,66,296,9154
E9817,49,56,59,56,76,296,9155
E1571,71,46,43,83,53,296,9156
E4993,82,61,52,45,56,296,9157
E6269,79,49,43,64,61,296,9158
E0602,70,78,45,55,48,296,9159
E9360,41,55,83,72,45,296,9160
E4424,60,43,61,60,72,296,9161
E6532,63,51,41,85,56,296,9162
E1149,68,55,47,63,63,296,9163
E6540,46,82,71,56,41,296,9164
E4661,62,40,52,62,80,296,9165
E3194,79,51,49,71,46,296,9166
E0209,99,56,49,44,48,296,9167
E5499,43,79,69,62,43,296,9168
E2848,82,55,44,44,71,296,9169
E7234,77,41,58,42,78,296,9170
E4236,62,76,43,74,41,296,9171
E3775,45,49,62,89,51,296,9172
E9825,99,68,43,45,41,296,9173
E0743,40,60,82,52,62,296,9174
E0018,99,46,46,40,65,296,9175
E9896,54,58,55,60,69,296,9176
E9994,84,55,40,69,48,296,9177
E1081,43,40,79,44,89,295,9178
E3267,49,62,87,48,49,295,9179
E3357,48,47,52,61,87,295,9180
E8814,40,61,40,70,84,295,9181
E2852,64,53,51,82,45,295,9182
E6026,42,44,80,85,44,295,9183
E6647,45,67,57,69,57,295,9184
E5313,54,63,87,41,50,295,9185
E2072,66,63,47,69,50,295,9186
E1931,88,47,43,64,53,295,9187
E5937,55,61,46,63,70,295,9188
E7151,72,43,93,45,42,295,9189
E6743,42,68,55,75,55,295,9190
E3698,56,79,41,57,62,295,9191
E2783,42,54,95,41,63,295,9192
E4376,46,82,57,61,49,295,9193
E6478,68,43,53,64,67,295,9194
E3137,48,53,83,58,53,295,9195
E4201,55,49,46,47,98,295,9196
E0545,70,79,57,46,43,295,9197
E9996,54,72,71,52,46,295,9198
E5337,72,74,52,57,40,295,9199
E2476,66,63,58,56,52,295,9200
E0680,47,77,57,68,46,295,9201
E8258,42,42,72,85,54,295,9202
E7649,51,41,60,79,64,295,9203
E2964,52,45,58,92,48,295,9204
E1488,56,50,95,50,44,295,9205
E8056,74,76,41,52,52,295,9206
E8138,40,55,46,84,70,295,9207
E0479,55,67,46,86,41,295,9208
E8162,52,55,45,65,78,295,9209
E2311,65,60,77,42,51,295,9210
E3902,46,83,44,51,71,295,9211
E7722,53,55,71,60,56,295,9212
E9033,54,51,40,50,99,294,9213
E6290,52,40,56,87,59,294,9214
E6003,47,88,57,61,41,294,9215
E9947,44,48,73,57,72,294,9216
E0233,55,41,85,53,60,294,9217
E0682,69,87,51,46,41,294,9218
E1355,77,67,62,44,44,294,9219
E6070,56,85,53,59,41,294,9220
E0173,53,52,66,59,64,294,9221
E2773,41,69,54,55,75,294,9222
E6823,63,45,66,50,70,294,9223
E3340,78,58,42,70,46,294,9224
E8046,47,41,59,55,92,294,9225
E7574,66,46,76,55,51,294,9226
E0042,49,77,41,62,65,294,9227
E4346,43,68,60,71,52,294,9228
E9249,67,47,42,77,61,294,9229
E2053,47,80,59,41,67,294,9230
E2688,45,53,68,72,56,294,9231
E0026,63,56,41,52,82,294,9232
E3926,74,54,46,48,72,294,9233
E6604,64,70,51,52,57,294,9234
E3838,64,46,50,47,87,294,9235
E2465,64,82,51,51,46,294,9236
E9636,49,75,40,50,80,294,9237
E5737,46,79,56,43,70,294,9238
E3058,79,41,55,57,62,294,9239
E2419,76,40,47,74,57,294,9240
E6145,46,76,44,68,60,294,9241
E0128,50,49,76,69,50,294,9242
E8247,45,52,83,62,52,294,9243
E4313,54,56,73,49,62,294,9244
E5333,76,49,57,55,57,294,9245
E0004,47,51,62,50,84,294,9246
E8981,54,46,90,61,42,293,9247
E8246,44,80,59,67,43,293,9248
E6450,57,82,51,62,41,293,9249
E2207,49,54,46,86,58,293,9250
E5094,59,64,56,47,67,293,9251
E0918,53,75,41,72,52,293,9252
E5636,63,49,48,54,79,293,9253
E3527,41,48,57,77,70,293,9254
E9154,53,51,68,55,66,293,9255
E0216,45,98,45,42,63,293,9256
E7318,76,69,41,64,43,293,9257
E0414,52,46,81,59,55,293,9258
E2910,54,80,54,46,59,293,9259
E8482,44,53,83,61,52,293,9260
E4481,44,84,57,68,40,293,9261
E5233,54,70,44,50,75,293,9262
E0732,46,49,64,65,69,293,9263
E4438,48,50,56,83,56,293,9264
E1059,47,51,79,74,42,293,9265
E5544,43,64,74,72,40,293,9266
E2961,52,65,48,55,73,293,9267
E9095,85,60,57,51,40,293,9268
E3006,83,40,44,46,80,293,9269
E2893,60,44,51,42,96,293,9270
E2596,59,57,40,54,83,293,9271
E7059,73,52,58,51,59,293,9272
E2208,100,69,43,40,41,293,9273
E1903,75,56,61,40,61,293,9274
E3458,50,48,72,75,48,293,9275
E9597,77,42,70,62,42,293,9276
E1470,52,49,81,41,70,293,9277
E7240,60,100,40,47,46,293,9278
E1483,70,52,77,44,50,293,9279
E4684,70,46,77,45,55,293,9280
E0142,60,58,46,80,49,293,9281
E8843,48,79,55,58,53,293,9282
E7581,46,75,50,68,54,293,9283
E1453,43,63,61,57,69,293,9284
E7781,53,51,49,49,91,293,9285
E4177,79,47,54,66,47,293,9286
E8414,60,41,49,54,89,293,9287
E7215,42,94,59,55,43,293,9288
E6481,50,51,51,52,89,293,9289
E9646,69,66,45,45,67,292,9290
E0965,51,45,90,60,46,292,9291
E5700,50,86,45,50,61,292,9292
E1185,58,79,61,43,51,292,9293
E0741,62,55,42,71,62,292,9294
E0222,42,67,67,56,60,292,9295
E0841,69,45,85,42,51,292,9296
E8559,46,56,63,52,75,292,9297
E6065,65,44,41,60,82,292,9298
E0528,50,44,66,67,65,292,9299
E1102,61,56,49,41,85,292,9300
E9839,50,46,77,62,57,292,9301
E8755,49,49,93,45,56,292,9302
E3733,57,46,62,44,83,292,9303
E6406,41,42,70,63,76,292,9304
E2648,54,79,40,65,54,292,9305
E0152,47,62,64,62,57,292,9306
E8924,58,60,52,58,64,292,9307
E1290,77,53,40,47,75,292,9308
E8732,55,49,97,40,51,292,9309
E2997,51,88,73,40,40,292,9310
E1431,62,64,63,52,51,292,9311
E9465,77,48,63,48,56,292,9312
E2789,56,50,66,77,43,292,9313
E4136,47,70,58,54,63,292,9314
E7648,57,55,54,52,74,292,9315
E8874,44,47,51,100,50,292,9316
E3361,64,47,47,81,53,292,9317
E2371,45,57,41,69,80,292,9318
E9721,72,42,55,51,72,292,9319
E3754,61,52,87,43,49,292,9320
E7872,44,86,64,54,44,292,9321
E6771,48,46,40,78,80,292,9322
E7740,52,67,47,44,82,292,9323
E0498,81,53,50,68,40,292,9324
E0076,77,47,49,69,50,292,9325
E2943,66,44,45,70,67,292,9326
E8092,50,91,45,45,61,292,9327
E9473,47,61,75,50,59,292,9328
E3966,56,65,50,81,40,292,9329
E6662,45,60,64,57,65,291,9330
E4208,56,49,69,69,48,291,9331
E9464,84,60,62,42,43,291,9332
E7665,69,43,58,65,56,291,9333
E7460,79,47,40,53,72,291,9334
E4446,45,57,77,59,53,291,9335
E8215,43,55,74,54,65,291,9336
E3465,61,75,47,51,57,291,9337
E0942,53,93,53,45,47,291,9338
E0720,59,49,45,51,87,291,9339
E5325,40,42,72,70,67,291,9340
E6810,50,61,48,42,90,291,9341
E2206,40,48,73,67,63,291,9342
E6160,57,46,70,73,45,291,9343
E3767,76,42,65,59,49,291,9344
E9569,88,47,73,42,41,291,9345
E1944,55,53,86,56,41,291,9346
E6210,50,57,59,81,44,291,9347
E4190,76,49,71,40,55,291,9348
E9300,79,57,51,55,49,291,9349
E1195,67,42,55,54,73,291,9350
E9131,88,67,46,48,42,291,9351
E9600,41,75,58,45,72,291,9352
E7624,48,42,87,60,54,291,9353
E8570,62,58,40,51,80,291,9354
E0866,42,49,75,84,41,291,9355
E3377,66,47,70,52,56,291,9356
E4979,73,45,53,67,52,290,9357
E7219,55,61,46,62,66,290,9358
E8036,43,54,75,59,59,290,9359
E2745,49,89,41,50,61,290,9360
E9974,65,45,50,77,53,290,9361
E9073,47,56,65,76,46,290,9362
E2281,54,43,52,56,85,290,9363
E7816,67,40,60,50,73,290,9364
E0768,44,67,84,48,47,290,9365
E4034,56,46,58,77,53,290,9366
E2096,44,40,82,71,53,290,9367
E6684,66,80,52,44,48,290,9368
E0489,56,43,52,88,51,290,9369
E0840,50,44,89,59,48,290,9370
E7639,78,65,57,42,48,290,9371
E9311,44,54,51,59,82,290,9372
E1784,63,64,50,50,63,290,9373
E1835,52,45,64,41,88,290,9374
E1750,88,80,41,40,41,290,9375
E9106,82,49,45,46,68,290,9376
E1711,67,52,44,64,63,290,9377
E1086,49,59,74,50,58,290,9378
E5268,61,55,61,55,58,290,9379
E3224,41,65,43,46,95,290,9380
E1712,82,43,52,54,59,290,9381
E4204,87,44,67,45,47,290,9382
E0344,68,47,56,52,67,290,9383
E5730,41,73,44,45,87,290,9384
E6990,53,69,55,42,71,290,9385
E5215,76,54,48,43,68,289,9386
E9951,60,45,55,49,80,289,9387
E6910,42,57,53,48,89,289,9388
E6338,47,82,45,48,67,289,9389
E6188,58,41,58,44,88,289,9390
E2162,63,65,40,62,59,289,9391
E8071,67,40,86,53,43,289,9392
E5620,79,42,73,45,50,289,9393
E0008,58,47,40,87,57,289,9394
E5774,53,46,63,71,56,289,9395
E6591,52,65,61,59,52,289,9396
E5999,41,42,48,58,100,289,9397
E0412,68,46,66,49,60,289,9398
E8203,80,62,44,58,45,289,9399
E7728,81,70,45,40,53,289,9400
E2886,83,40,60,46,60,289,9401
E2574,60,49,41,98,41,289,9402
E3608,66,67,48,47,61,289,9403
E2845,43,53,72,46,75,289,9404
E9954,84,44,47,43,71,289,9405
E8387,40,66,88,54,41,289,9406
E4368,93,42,52,54,48,289,9407
E0880,50,58,55,44,82,289,9408
E8686,40,52,79,49,69,289,9409
E2441,54,65,77,48,45,289,9410
E0163,58,60,76,45,50,289,9411
E3619,71,43,86,41,48,289,9412
E9483,72,62,41,42,72,289,9413
E0357,65,47,41,90,46,289,9414
E6947,54,41,67,67,60,289,9415
E1125,45,78,40,54,72,289,9416
E2348,94,46,44,43,62,289,9417
E6761,74,57,45,64,49,289,9418
E8635,56,57,45,40,91,289,9419
E2220,48,43,89,64,45,289,9420
E9054,79,41,57,56,56,289,9421
E4597,41,61,65,79,42,288,9422
E5613,50,49,92,43,54,288,9423
E0832,45,97,40,41,65,288,9424
E2555,42,74,45,49,78,288,9425
E8668,68,60,70,49,41,288,9426
E3219,62,49,46,42,89,288,9427
E1564,65,44,48,75,56,288,9428
E2998,42,42,71,91,42,288,9429
E1678,69,50,48,64,57,288,9430
E1780,53,65,83,43,44,288,9431
E0098,66,47,56,44,75,288,9432
E5227,51,66,47,57,67,288,9433
E2780,42,55,40,80,71,288,9434
E1279,41,43,64,73,67,288,9435
E2841,41,43,51,76,77,288,9436
E1588,52,45,59,69,63,288,9437
E9914,41,76,42,49,80,288,9438
E1550,63,43,55,72,55,288,9439
E5913,43,78,42,40,85,288,9440
E3049,73,59,45,58,53,288,9441
E0975,46,45,45,92,60,288,9442
E2492,68,47,48,47,78,288,9443
E9432,53,42,82,60,51,288,9444
E8030,41,60,41,70,76,288,9445
E5493,73,70,56,43,46,288,9446
E7969,45,80,40,61,62,288,9447
E0063,73,42,49,60,64,288,9448
E5399,49,51,85,53,50,288,9449
E2240,70,56,42,53,67,288,9450
E6735,45,71,49,56,67,288,9451
E1116,58,45,66,61,58,288,9452
E1921,48,71,67,56,46,288,9453
E1273,78,59,40,61,50,288,9454
E4096,50,49,58,67,64,288,9455
E9196,48,59,42,50,89,288,9456
E7833,55,56,45,43,88,287,9457
E0990,67,51,71,43,55,287,9458
E0390,48,57,82,55,45,287,9459
E6315,41,67,48,72,59,287,9460
E5637,63,43,72,53,56,287,9461
E9295,57,72,45,41,72,287,9462
E2074,94,53,43,49,48,287,9463
E6121,52,66,63,65,41,287,9464
E5380,67,49,67,40,64,287,9465
E2216,49,59,48,75,56,287,9466
E9162,42,42,45,59,99,287,9467
E8373,47,65,84,48,43,287,9468
E1278,45,90,46,63,43,287,9469
E3454,50,44,41,94,58,287,9470
E4763,81,42,49,43,72,287,9471
E3707,41,57,68,61,60,287,9472
E6251,42,49,78,46,72,287,9473
E8828,59,67,52,52,57,287,9474
E7696,44,71,57,70,45,287,9475
E1645,41,97,43,56,50,287,9476
E9840,88,47,56,41,55,287,9477
E5491,48,95,44,46,54,287,9478
E7895,73,42,43,85,44,287,9479
E1737,62,49,57,68,51,287,9480
E3214,82,43,52,66,44,287,9481
E1089,51,48,52,44,91,286,9482
E9535,53,48,54,53,78,286,9483
E9237,54,48,43,77,64,286,9484
E7708,72,60,41,68,45,286,9485
E9654,87,63,43,42,51,286,9486
E7676,65,76,61,41,43,286,9487
E4837,64,52,79,45,46,286,9488
E0085,48,48,50,85,55,286,9489
E8801,45,67,70,51,53,286,9490
E6393,65,44,74,53,50,286,9491
E9356,41,75,48,72,50,286,9492
E1128,66,57,48,48,67,286,9493
E5989,44,67,44,43,88,286,9494
E8709,55,50,44,42,95,286,9495
E7985,50,62,78,55,41,286,9496
E5888,46,55,60,50,75,286,9497
E0787,47,44,44,73,78,286,9498
E6508,72,54,56,43,61,286,9499
E5029,42,77,53,57,57,286,9500
E1330,51,41,54,92,48,286,9501
E0526,75,46,67,53,45,286,9502
E2610,71,48,52,61,54,286,9503
E7553,40,67,43,53,83,286,9504
E8449,58,51,55,41,80,285,9505
E8519,53,65,79,44,44,285,9506
E8397,68,50,48,66,53,285,9507
E5336,77,47,56,51,54,285,9508
E2198,44,87,61,47,46,285,9509
E9157,77,42,69,42,55,285,9510
E7391,49,56,67,70,43,285,9511
E5632,72,45,44,73,51,285,9512
E1528,82,46,55,52,50,285,9513
E1398,51,67,80,47,40,285,9514
E2382,45,47,57,78,58,285,9515
E4519,80,48,59,47,51,285,9516
E7102,43,86,64,49,43,285,9517
E4116,40,91,44,50,60,285,9518
E9006,70,41,55,45,74,285,9519
E7009,87,57,52,41,48,285,9520
E8692,43,47,58,53,84,285,9521
E8442,61,56,44,46,78,285,9522
E4390,54,41,41,71,78,285,9523
E4665,56,40,50,99,40,285,9524
E5751,47,48,40,79,71,285,9525
E6189,52,47,48,64,74,285,9526
E0999,65,42,94,42,42,285,9527
E9350,45,41,41,77,81,285,9528
E6060,44,40,58,47,96,285,9529
E1366,82,70,44,45,44,285,9530
E6791,45,53,92,50,45,285,9531
E2847,73,55,64,40,53,285,9532
E5249,44,45,91,63,42,285,9533
E0459,53,63,60,64,44,284,9534
E6738,49,50,51,54,80,284,9535
E9570,53,44,70,46,71,284,9536
E2522,52,74,45,47,66,284,9537
E0658,40,75,42,42,85,284,9538
E7255,52,57,44,44,87,284,9539
E2138,50,75,54,46,59,284,9540
E9014,57,61,45,69,52,284,9541
E3468,75,49,52,40,68,284,9542
E7199,46,54,63,61,60,284,9543
E9748,54,42,68,63,57,284,9544
E9611,68,70,55,45,46,284,9545
E0557,51,58,44,82,49,284,9546
E9945,73,42,57,52,60,284,9547
E1969,63,67,48,56,50,284,9548
E1270,42,73,44,58,67,284,9549
E3024,45,53,73,64,49,284,9550
E5127,40,53,63,72,56,284,9551
E2655,45,81,53,61,44,284,9552
E3503,58,40,56,56,74,284,9553
E3182,60,82,43,48,51,284,9554
E7725,45,66,57,51,65,284,9555
E4719,44,52,84,45,59,284,9556
E3971,58,52,40,80,54,284,9557
E4383,41,46,83,47,67,284,9558
E2831,41,70,53,43,77,284,9559
E3201,55,63,49,56,61,284,9560
E6646,78,44,57,60,45,284,9561
E7408,70,49,46,51,68,284,9562
E4348,47,66,70,52,49,284,9563
E3203,40,50,87,57,50,284,9564
E7945,46,50,55,44,89,284,9565
E9216,65,42,92,43,42,284,9566
E3761,56,42,78,41,67,284,9567
E1359,74,45,47,59,59,284,9568
E1976,61,41,73,47,62,284,9569
E8297,59,61,49,66,48,283,9570
E8968,45,68,45,60,65,283,9571
E1542,40,82,40,68,53,283,9572
E6914,87,55,42,42,57,283,9573
E2938,58,41,58,64,62,283,9574
E7335,41,47,78,65,52,283,9575
E4888,54,40,58,60,71,283,9576
E7183,66,68,53,52,44,283,9577
E7325,60,61,58,42,62,283,9578
E1165,40,49,50,54,90,283,9579
E7903,45,40,50,79,69,283,9580
E2669,42,58,68,74,41,283,9581
E4131,45,40,71,75,52,283,9582
E0707,61,41,72,46,63,283,9583
E3009,65,58,56,64,40,283,9584
E4560,53,75,42,67,46,283,9585
E0936,62,80,48,40,53,283,9586
E8518,69,44,64,61,45,283,9587
E1342,45,56,64,74,44,283,9588
E7888,61,60,40,50,72,283,9589
E6882,79,44,50,59,51,283,9590
E1916,50,55,51,56,71,283,9591
E3862,49,41,53,40,99,282,9592
E2174,41,44,62,74,61,282,9593
E1020,84,60,58,40,40,282,9594
E2695,83,63,41,44,51,282,9595
E9832,40,41,63,93,45,282,9596
E3938,76,40,45,40,81,282,9597
E1474,67,62,49,51,53,282,9598
E7039,50,68,62,53,49,282,9599
E1373,55,45,47,90,45,282,9600
E1772,86,54,41,50,51,282,9601
E2112,71,62,53,54,42,282,9602
E8587,55,51,69,64,43,282,9603
E6025,74,67,45,50,46,282,9604
E5010,40,55,66,78,43,282,9605
E6386,82,41,56,42,61,282,9606
E7307,60,59,56,65,42,282,9607
E7675,40,72,60,48,62,282,9608
E9693,48,66,49,78,41,282,9609
E5693,86,50,40,63,43,282,9610
E2171,48,47,47,91,49,282,9611
E3291,49,53,74,52,54,282,9612
E9883,50,63,41,81,47,282,9613
E1115,72,46,73,46,45,282,9614
E3670,45,68,41,42,86,282,9615
E8660,59,50,48,62,63,282,9616
E7030,41,42,72,57,70,282,9617
E2776,67,41,59,74,40,281,9618
E5497,53,44,75,44,65,281,9619
E2874,70,59,57,53,42,281,9620
E1603,58,75,56,48,44,281,9621
E4066,69,64,63,43,42,281,9622
E9343,82,71,40,42,46,281,9623
E1219,74,63,41,49,54,281,9624
E1768,46,82,41,57,55,281,9625
E9449,43,40,53,46,99,281,9626
E6359,40,69,61,59,52,281,9627
E0346,57,58,49,62,55,281,9628
E2844,40,75,52,73,41,281,9629
E3193,49,47,53,72,60,281,9630
E1298,77,50,40,44,70,281,9631
E1562,42,64,70,44,61,281,9632
E6219,54,50,41,88,48,281,9633
E9056,69,47,54,48,63,281,9634
E8479,41,46,41,79,74,281,9635
E8555,69,44,40,79,49,281,9636
E0976,40,40,82,59,60,281,9637
E4923,50,43,45,72,71,281,9638
E8374,46,69,79,43,44,281,9639
E5604,68,70,42,49,52,281,9640
E5615,52,48,58,82,41,281,9641
E4729,40,42,61,54,84,281,9642
E6377,45,95,40,45,56,281,9643
E0447,78,55,63,42,42,280,9644
E0463,54,47,47,80,52,280,9645
E3062,45,79,73,43,40,280,9646
E6888,62,41,46,84,47,280,9647
E5932,55,51,54,46,74,280,9648
E2619,46,75,55,48,56,280,9649
E9405,43,51,62,47,77,280,9650
E2557,57,42,75,44,62,280,9651
E1216,56,42,55,41,86,280,9652
E2030,40,54,84,52,50,280,9653
E4857,47,77,40,53,63,280,9654
E0452,59,43,57,70,51,280,9655
E0845,40,43,53,54,90,280,9656
E8119,43,50,49,53,84,279,9657
E8796,90,47,48,47,47,279,9658
E7860,56,43,49,62,69,279,9659
E7339,94,42,51,44,48,279,9660
E1743,67,74,50,42,46,279,9661
E2258,53,71,58,42,55,279,9662
E2325,66,51,73,42,47,279,9663
E3283,44,49,73,50,63,279,9664
E1928,75,45,44,50,65,279,9665
E2652,72,61,49,51,46,279,9666
E6721,75,42,57,43,62,279,9667
E2270,76,46,68,41,48,279,9668
E7661,54,71,64,44,45,278,9669
E4226,51,52,66,51,58,278,9670
E7439,62,54,63,43,56,278,9671
E5916,65,41,52,68,52,278,9672
E0363,43,45,79,61,50,278,9673
E0193,45,40,71,64,58,278,9674
E9484,80,49,44,52,53,278,9675
E2550,59,72,61,41,45,278,9676
E5946,77,50,41,51,59,278,9677
E4140,49,47,49,76,57,278,9678
E3363,70,56,47,47,58,278,9679
E0215,62,48,47,66,55,278,9680
E0686,56,45,50,68,59,278,9681
E6140,94,45,50,40,49,278,9682
E3720,41,64,92,41,40,278,9683
E1658,93,41,42,45,57,278,9684
E6916,41,96,47,42,52,278,9685
E8371,53,54,46,50,75,278,9686
E7378,65,70,51,50,42,278,9687
E3352,53,44,53,64,64,278,9688
E9509,78,40,47,52,61,278,9689
E1905,50,56,62,68,42,278,9690
E8379,62,54,58,46,58,278,9691
E7097,62,66,46,57,47,278,9692
E2408,62,40,64,62,49,277,9693
E9718,50,63,58,53,53,277,9694
E7072,54,74,50,44,55,277,9695
E6806,70,50,45,60,52,277,9696
E4998,61,40,75,43,58,277,9697
E2253,60,47,48,72,50,277,9698
E1566,40,99,43,41,54,277,9699
E8848,47,75,56,47,52,277,9700
E0079,70,54,53,57,43,277,9701
E3850,58,45,41,89,44,277,9702
E9315,41,41,80,64,51,277,9703
E0174,56,52,67,53,48,276,9704
E0159,50,42,82,60,42,276,9705
E3244,48,57,63,44,64,276,9706
E2913,97,42,45,48,44,276,9707
E0082,51,56,50,79,40,276,9708
E5990,64,47,59,57,49,276,9709
E6391,41,42,73,67,53,276,9710
E1408,49,60,51,41,75,276,9711
E1217,53,61,45,67,50,276,9712
E0956,75,52,40,47,62,276,9713
E0083,42,53,51,49,81,276,9714
E0035,59,45,43,84,45,276,9715
E5984,54,65,45,67,45,276,9716
E4165,62,42,43,85,44,276,9717
E0555,74,53,61,47,41,276,9718
E1452,56,71,42,40,67,276,9719
E6533,45,43,76,70,42,276,9720
E3375,42,65,66,42,61,276,9721
E0951,54,40,65,51,66,276,9722
E4772,51,62,54,51,58,276,9723
E8501,50,40,74,55,57,276,9724
E0614,62,63,43,48,60,276,9725
E5545,77,47,44,57,51,276,9726
E5223,43,85,49,49,50,276,9727
E5524,60,62,43,47,63,275,9728
E3975,82,45,45,51,52,275,9729
E4624,64,41,40,55,75,275,9730
E7355,68,52,59,48,48,275,9731
E2656,46,42,72,74,41,275,9732
E6678,61,53,43,52,66,275,9733
E4357,44,43,43,88,57,275,9734
E9770,86,56,46,47,40,275,9735
E6348,46,43,70,75,41,275,9736
E1806,57,59,53,63,43,275,9737
E3901,60,50,60,46,59,275,9738
E0314,42,40,48,89,56,275,9739
E0627,51,79,44,51,50,275,9740
E3392,45,52,84,48,46,275,9741
E8673,44,44,46,45,96,275,9742
E3207,55,70,44,55,51,275,9743
E5759,53,58,69,51,44,275,9744
E3847,57,44,65,40,69,275,9745
E3395,62,47,47,59,60,275,9746
E1314,42,48,49,67,69,275,9747
E0642,79,55,44,51,46,275,9748
E6918,76,40,50,66,43,275,9749
E2351,45,91,52,46,40,274,9750
E7527,47,51,49,41,86,274,9751
E8333,62,65,61,40,46,274,9752
E7465,43,40,91,49,51,274,9753
E6943,68,40,52,50,64,274,9754
E4878,41,46,70,67,50,274,9755
E6974,44,74,45,63,48,274,9756
E8044,62,45,70,44,53,274,9757
E0537,41,42,40,68,83,274,9758
E1861,44,45,45,80,60,274,9759
E0763,44,41,51,95,43,274,9760
E3275,45,56,46,44,83,274,9761
E2058,46,43,61,83,41,274,9762
E7406,40,53,54,83,44,274,9763
E5110,42,50,56,63,62,273,9764
E9000,53,81,56,43,40,273,9765
E8759,76,44,59,51,43,273,9766
E4146,40,53,86,43,51,273,9767
E6814,56,40,54,64,59,273,9768
E0473,41,43,79,49,61,273,9769
E9864,69,54,40,58,52,273,9770
E9072,61,64,56,41,51,273,9771
E3660,69,56,56,52,40,273,9772
E1392,54,40,41,57,81,273,9773
E6053,45,93,40,49,46,273,9774
E1265,40,46,61,76,49,272,9775
E6762,49,58,43,47,75,272,9776
E5485,42,78,44,42,66,272,9777
E9562,48,51,60,43,70,272,9778
E3308,47,65,42,60,58,272,9779
E6229,58,59,50,51,54,272,9780
E9530,43,53,45,50,81,272,9781
E6088,49,58,71,41,53,272,9782
E6920,48,63,40,66,55,272,9783
E2099,46,62,75,47,42,272,9784
E6190,53,45,40,88,46,272,9785
E7800,56,41,66,68,41,272,9786
E0137,63,57,46,53,53,272,9787
E3821,66,73,42,51,40,272,9788
E2687,62,41,52,64,53,272,9789
E3070,51,43,68,57,53,272,9790
E4842,49,49,62,45,66,271,9791
E7088,65,57,54,44,51,271,9792
E7316,64,44,61,62,40,271,9793
E8439,42,59,81,44,45,271,9794
E5384,43,44,44,93,47,271,9795
E5293,57,43,44,87,40,271,9796
E3510,63,40,64,41,63,271,9797
E4068,56,45,43,74,53,271,9798
E7295,62,72,41,44,52,271,9799
E3059,57,51,42,70,51,271,9800
E1416,45,44,86,41,55,271,9801
E5425,81,45,40,52,53,271,9802
E3499,40,46,69,59,57,271,9803
E4331,45,70,66,44,45,270,9804
E4245,48,53,75,52,42,270,9805
E8699,84,55,47,43,41,270,9806
E9663,55,78,42,49,46,270,9807
E4637,47,41,65,62,55,270,9808
E9098,41,72,44,48,65,270,9809
E3729,43,57,64,57,49,270,9810
E3743,40,75,42,50,63,270,9811
E7577,70,61,48,43,48,270,9812
E4688,76,54,46,48,46,270,9813
E8911,60,45,47,50,68,270,9814
E6755,42,64,54,43,66,269,9815
E4784,46,51,42,64,66,269,9816
E8377,44,45,50,85,45,269,9817
E9303,47,46,48,42,86,269,9818
E7186,42,54,50,40,83,269,9819
E6726,48,60,51,66,44,269,9820
E9371,45,47,65,60,52,269,9821
E6667,66,55,56,43,49,269,9822
E0290,43,51,51,55,69,269,9823
E1338,64,46,66,47,46,269,9824
E1578,53,68,45,49,53,268,9825
E6339,41,82,54,49,42,268,9826
E5783,40,57,43,52,76,268,9827
E6295,64,41,51,60,52,268,9828
E2573,40,41,49,90,48,268,9829
E0789,41,50,42,80,55,268,9830
E8424,65,41,65,53,44,268,9831
E6845,44,44,51,78,51,268,9832
E3174,49,54,46,79,40,268,9833
E1472,46,74,49,56,43,268,9834
E6054,81,44,61,40,42,268,9835
E6825,43,47,41,82,54,267,9836
E9061,41,43,74,41,68,267,9837
E2590,63,40,54,62,48,267,9838
E8009,50,42,60,70,45,267,9839
E6116,45,54,40,86,42,267,9840
E8798,45,67,50,50,55,267,9841
E9096,48,73,46,52,48,267,9842
E5147,56,53,52,42,64,267,9843
E0709,42,49,70,65,40,266,9844
E5057,42,53,78,47,46,266,9845
E7743,48,40,55,83,40,266,9846
E6127,42,72,55,56,41,266,9847
E5702,50,67,49,58,42,266,9848
E0089,47,45,47,60,67,266,9849
E2761,70,51,56,44,45,266,9850
E4874,58,44,61,48,55,266,9851
E3064,40,76,48,40,61,265,9852
E6007,56,42,44,47,76,265,9853
E8534,55,40,71,44,55,265,9854
E8822,57,50,40,67,51,265,9855
E3842,47,59,63,48,48,265,9856
E1581,81,40,44,51,49,265,9857
E7506,46,43,60,51,65,265,9858
E6601,63,41,78,40,43,265,9859
E4047,45,40,79,61,40,265,9860
E0905,70,42,48,61,44,265,9861
E0925,55,79,44,41,46,265,9862
E8679,55,42,72,50,46,265,9863
E8972,65,55,48,40,57,265,9864
E8039,50,41,52,76,46,265,9865
E9476,51,55,51,66,41,264,9866
E0638,42,43,54,75,50,264,9867
E0257,59,71,45,47,42,264,9868
E5553,59,56,54,55,40,264,9869
E8330,46,55,63,49,51,264,9870
E8516,48,40,48,61,67,264,9871
E6633,58,49,59,45,53,264,9872
E8652,42,45,51,44,82,264,9873
E8400,44,65,49,46,60,264,9874
E8103,63,65,45,49,42,264,9875
E9278,53,56,43,57,55,264,9876
E6332,54,44,42,71,53,264,9877
E5764,50,66,46,48,54,264,9878
E7668,52,46,55,40,71,264,9879
E3935,50,50,43,73,48,264,9880
E3593,53,54,50,64,43,264,9881
E7727,47,55,40,71,51,264,9882
E0694,47,46,46,60,64,263,9883
E3936,49,42,52,52,68,263,9884
E8902,51,45,50,60,57,263,9885
E3519,79,47,41,40,56,263,9886
E8425,44,62,52,40,65,263,9887
E3253,55,54,43,54,57,263,9888
E0872,53,53,48,55,54,263,9889
E4985,67,53,40,55,48,263,9890
E1676,42,67,40,46,67,262,9891
E4943,43,50,61,46,62,262,9892
E2993,75,42,59,40,46,262,9893
E3447,42,71,61,45,43,262,9894
E5056,71,43,53,44,51,262,9895
E5323,53,55,66,40,48,262,9896
E4959,61,62,41,43,55,262,9897
E1915,42,44,62,67,46,261,9898
E2140,52,65,51,45,48,261,9899
E2743,48,48,61,55,49,261,9900
E9958,43,47,73,50,48,261,9901
E4336,50,53,40,64,54,261,9902
E2732,95,43,43,40,40,261,9903
E0144,47,48,45,55,66,261,9904
E0112,69,43,52,55,42,261,9905
E5000,65,45,42,45,64,261,9906
E7257,62,40,44,42,73,261,9907
E3568,41,52,48,40,80,261,9908
E1864,68,48,43,50,51,260,9909
E2764,63,42,60,53,42,260,9910
E7570,58,41,45,76,40,260,9911
E6267,54,65,40,42,59,260,9912
E2806,43,41,49,57,70,260,9913
E5122,65,49,51,44,51,260,9914
E9397,57,43,51,59,49,259,9915
E1411,50,74,50,44,41,259,9916
E0430,64,52,43,47,53,259,9917
E8094,43,51,53,55,57,259,9918
E5591,58,61,42,52,46,259,9919
E3170,41,50,43,82,43,259,9920
E5817,61,45,41,71,40,258,9921
E0220,40,42,53,50,73,258,9922
E3387,40,63,40,69,46,258,9923
E7334,52,42,60,40,64,258,9924
E2458,42,43,40,63,70,258,9925
E4848,49,51,58,42,57,257,9926
E7981,46,45,67,47,52,257,9927
E1311,59,44,63,40,51,257,9928
E7392,46,62,66,40,43,257,9929
E9470,65,53,46,40,52,256,9930
E7150,42,62,43,40,69,256,9931
E8835,43,73,41,55,44,256,9932
E2120,49,50,44,61,52,256,9933
E7517,43,43,53,74,42,255,9934
E9830,50,72,41,50,42,255,9935
E9109,77,46,47,45,40,255,9936
E1569,46,48,43,43,74,254,9937
E3121,44,61,48,52,49,254,9938
E3974,71,41,42,49,51,254,9939
E0519,47,59,53,52,42,253,9940
E9053,43,80,42,48,40,253,9941
E5244,40,63,48,51,51,253,9942
E9978,45,66,55,45,41,252,9943
E9090,61,57,43,48,43,252,9944
E8260,42,45,73,49,43,252,9945
E4287,49,59,41,63,40,252,9946
E5623,41,51,51,64,45,252,9947
E9731,47,42,66,54,42,251,9948
E4760,50,54,50,47,50,251,9949
E3373,57,50,48,44,52,251,9950
E2213,41,52,45,70,43,251,9951
E4671,42,58,62,48,41,251,9952
E7418,58,43,66,44,40,251,9953
E2002,45,42,65,57,41,250,9954
E1907,52,50,43,44,61,250,9955
E8812,41,44,61,47,57,250,9956
E2075,41,63,55,46,44,249,9957
E0620,58,45,60,44,41,248,9958
E7724,55,55,48,47,43,248,9959
E7062,52,42,57,40,57,248,9960
E9922,42,52,40,42,72,248,9961
E8166,42,46,50,62,47,247,9962
E7551,50,40,46,57,54,247,9963
E4738,41,47,41,48,70,247,9964
E2969,48,57,43,55,44,247,9965
E8391,62,45,51,46,43,247,9966
E3494,62,40,40,44,61,247,9967
E7042,43,42,61,40,60,246,9968
E1462,46,65,42,44,49,246,9969
E3306,42,40,83,41,40,246,9970
E2542,45,56,50,53,40,244,9971
E0797,44,45,55,43,56,243,9972
E5342,47,49,45,51,51,243,9973
E9980,44,61,51,42,44,242,9974
E3987,42,41,44,51,64,242,9975
E1400,49,40,58,45,50,242,9976
E8335,56,44,47,50,44,241,9977
E6543,66,45,41,45,44,241,9978
E4613,50,59,42,49,41,241,9979
E3277,62,51,41,41,45,240,9980
E8357,46,43,42,57,52,240,9981
E3702,43,45,51,49,51,239,9982
E0961,40,50,59,48,42,239,9983
E6077,40,40,42,61,56,239,9984
E3889,54,41,43,54,47,239,9985
E4419,47,42,47,47,55,238,9986
E5574,47,40,51,41,58,237,9987
E4877,53,44,53,41,46,237,9988
E0661,53,48,53,43,40,237,9989
E3719,50,45,42,51,49,237,9990
E3571,59,42,40,54,40,235,9991
E5454,41,63,40,48,42,234,9992
E3462,58,46,41,45,42,232,9993
E0028,40,41,49,58,43,231,9994
E6396,43,50,42,42,54,231,9995
E7491,50,43,45,47,44,229,9996
E3130,44,43,51,46,42,226,9997
E9724,41,40,56,40,49,226,9998
E3927,44,44,48,46,40,222,9999
E1718,50,47,40,41,41,219,10000
